𝄛𝄛𝄛𝄛𝄛𝄛𝄛𝄛𝄛𝄛𝄛𝄛𝄛𝄛𝄛𝄛𝄛𝄛𝄛𝄛𝄛𝄛𝄛𝄛𝄛𝄛𝄛𝄛𝄛𝄛𝄛𝄛𝄛𝄛𝄛𝄛𝄛𝄛𝄛𝄛𝄛𝄛𝄛𝄛𝄛𝄛𝄛𝄛𝄛𝄛𝄛𝄛𝄛𝄛𝄛𝄛𝄛𝄛░░░░░░░𝄛𝄛𝄛░░░░𝄛𝄛𝄛𝄛𝄛░░░░░𝄛𝄛𝄛𝄛𝄛𝄛𝄛𝄛𝄛𝄛𝄛𝄛𝄛𝄛𝄛𝄛𝄛𝄛𝄛𝄛𝄛𝄛𝄛𝄛𝄛𝄛𝄛𝄛𝄛𝄛𝄛𝄛𝄛𝄛𝄛𝄛𝄛𝄛𝄛𝄛𝄛𝄛𝄛𝄛𝄛𝄛𝄛𝄛𝄛𝄛𝄛𝄛𝄛𝄛𝄛𝄛𝄛𝄛
𝄛𝄛𝄛𝄛𝄛𝄛𝄛𝄛𝄛𝄛𝄛𝄛𝄛𝄛𝄛𝄛𝄛𝄛𝄛𝄛𝄛𝄛𝄛𝄛𝄛𝄛𝄛𝄛𝄛𝄛𝄛𝄛𝄛𝄛𝄛𝄛𝄛𝄛𝄛𝄛𝄛𝄛𝄛𝄛𝄛𝄛𝄛𝄛𝄛𝄛░░░░░░░░░░░░𝄛𝄛𝄛𝄛𝄛𝄛𝄛░░░𝄛𝄛𝄛𝄛𝄛░░░𝄛𝄛𝄛𝄛𝄛𝄛𝄛𝄛𝄛𝄛𝄛𝄛𝄛𝄛𝄛𝄛𝄛𝄛𝄛𝄛𝄛𝄛𝄛𝄛𝄛𝄛𝄛𝄛𝄛𝄛𝄛𝄛𝄛𝄛𝄛𝄛𝄛𝄛𝄛𝄛𝄛𝄛𝄛𝄛𝄛𝄛𝄛𝄛𝄛𝄛𝄛𝄛𝄛𝄛𝄛𝄛𝄛𝄛𝄛𝄛
𝄛𝄛𝄛𝄛𝄛𝄛𝄛𝄛𝄛𝄛𝄛𝄛𝄛𝄛𝄛𝄛𝄛𝄛𝄛𝄛𝄛𝄛𝄛𝄛𝄛𝄛𝄛𝄛𝄛𝄛𝄛𝄛𝄛𝄛𝄛𝄛𝄛𝄛𝄛𝄛𝄛𝄛𝄛𝄛𝄛𝄛𝄛𝄛𝄛░░░░░░░░░░░𝄛𝄛𝄛𝄛𝄛𝄛𝄛𝄛𝄛░░░𝄛𝄛𝄛𝄛𝄛░░𝄛𝄛𝄛𝄛𝄛𝄛𝄛𝄛𝄛𝄛𝄛𝄛𝄛𝄛𝄛𝄛𝄛𝄛𝄛𝄛𝄛𝄛𝄛𝄛𝄛𝄛𝄛𝄛𝄛𝄛𝄛𝄛𝄛𝄛𝄛𝄛𝄛𝄛𝄛𝄛𝄛𝄛𝄛𝄛𝄛𝄛𝄛𝄛𝄛𝄛𝄛𝄛𝄛𝄛𝄛𝄛𝄛𝄛𝄛𝄛𝄛
𝄛𝄛𝄛𝄛𝄛𝄛𝄛𝄛𝄛𝄛𝄛𝄛𝄛𝄛𝄛𝄛𝄛𝄛𝄛𝄛𝄛𝄛𝄛𝄛𝄛𝄛𝄛𝄛𝄛𝄛𝄛𝄛𝄛𝄛𝄛𝄛𝄛𝄛𝄛𝄛𝄛𝄛𝄛𝄛𝄛𝄛𝄛𝄛░░░░░░░░░░░𝄛𝄛𝄛𝄛𝄛𝄛𝄛𝄛𝄛░░░░░𝄛𝄛𝄛░░░𝄛𝄛𝄛𝄛𝄛𝄛𝄛𝄛░░░𝄛𝄛𝄛𝄛𝄛𝄛𝄛𝄛𝄛𝄛𝄛𝄛𝄛𝄛𝄛𝄛𝄛𝄛𝄛𝄛𝄛𝄛𝄛𝄛𝄛𝄛𝄛𝄛𝄛𝄛𝄛𝄛𝄛𝄛𝄛𝄛𝄛𝄛𝄛𝄛𝄛𝄛𝄛𝄛𝄛𝄛𝄛𝄛𝄛𝄛
𝄛𝄛𝄛𝄛𝄛𝄛𝄛𝄛𝄛𝄛𝄛𝄛𝄛𝄛𝄛𝄛𝄛𝄛𝄛𝄛𝄛𝄛𝄛𝄛𝄛𝄛𝄛𝄛𝄛𝄛𝄛𝄛𝄛𝄛𝄛𝄛𝄛𝄛𝄛𝄛𝄛𝄛𝄛𝄛𝄛𝄛𝄛𝄛░░░░░░░░░░𝄛𝄛𝄛𝄛𝄛𝄛𝄛𝄛░░░░░░░░░░░░░𝄛𝄛𝄛𝄛𝄛𝄛𝄛░░░░░𝄛𝄛𝄛𝄛𝄛𝄛𝄛𝄛𝄛𝄛𝄛𝄛𝄛𝄛𝄛𝄛𝄛𝄛𝄛𝄛𝄛𝄛𝄛𝄛𝄛𝄛𝄛𝄛𝄛𝄛𝄛𝄛𝄛𝄛𝄛𝄛𝄛𝄛𝄛𝄛𝄛𝄛𝄛𝄛𝄛𝄛𝄛𝄛𝄛
𝄛𝄛𝄛𝄛𝄛𝄛𝄛𝄛𝄛𝄛𝄛𝄛𝄛𝄛𝄛𝄛𝄛𝄛𝄛𝄛𝄛𝄛𝄛𝄛𝄛𝄛𝄛𝄛𝄛𝄛𝄛𝄛𝄛𝄛𝄛𝄛𝄛𝄛𝄛𝄛𝄛𝄛𝄛𝄛𝄛𝄛𝄛𝄛𝄛░░░░░░░𝄛𝄛𝄛𝄛𝄛𝄛░░░░░░░𝄛𝄛░░░░░░░𝄛𝄛𝄛𝄛𝄛𝄛𝄛░░░░░░𝄛𝄛𝄛𝄛𝄛𝄛𝄛𝄛𝄛𝄛𝄛𝄛𝄛𝄛𝄛𝄛𝄛𝄛𝄛𝄛𝄛𝄛𝄛𝄛𝄛𝄛𝄛𝄛𝄛𝄛𝄛𝄛𝄛𝄛𝄛𝄛𝄛𝄛𝄛𝄛𝄛𝄛𝄛𝄛𝄛𝄛𝄛𝄛𝄛
𝄛𝄛𝄛𝄛𝄛𝄛𝄛𝄛𝄛𝄛𝄛𝄛𝄛𝄛𝄛𝄛𝄛𝄛𝄛𝄛𝄛𝄛𝄛𝄛𝄛𝄛𝄛𝄛𝄛𝄛𝄛𝄛𝄛𝄛𝄛𝄛𝄛𝄛𝄛𝄛𝄛𝄛░░░𝄛𝄛𝄛𝄛𝄛░░░░░𝄛𝄛𝄛𝄛𝄛𝄛░░░░░░░𝄛𝄛𝄛𝄛░░░░░░𝄛𝄛𝄛𝄛𝄛𝄛░░░░░░░𝄛𝄛𝄛𝄛𝄛𝄛𝄛𝄛𝄛𝄛𝄛𝄛𝄛𝄛𝄛𝄛𝄛𝄛𝄛𝄛𝄛𝄛𝄛𝄛𝄛𝄛𝄛𝄛𝄛𝄛𝄛𝄛𝄛𝄛𝄛𝄛𝄛𝄛𝄛𝄛𝄛𝄛𝄛𝄛𝄛𝄛𝄛𝄛𝄛
𝄛𝄛𝄛𝄛𝄛𝄛𝄛𝄛𝄛𝄛𝄛𝄛𝄛𝄛𝄛𝄛𝄛𝄛𝄛𝄛𝄛𝄛𝄛𝄛𝄛𝄛𝄛𝄛𝄛𝄛𝄛𝄛𝄛𝄛𝄛𝄛𝄛𝄛𝄛𝄛𝄛░░░░░𝄛𝄛𝄛𝄛𝄛░░░░𝄛𝄛𝄛𝄛𝄛░░░░░░░░𝄛𝄛𝄛𝄛░░░░░░░𝄛𝄛𝄛𝄛░░░░░░░░░𝄛𝄛𝄛𝄛𝄛𝄛𝄛𝄛𝄛𝄛𝄛𝄛𝄛𝄛𝄛𝄛𝄛𝄛𝄛𝄛𝄛𝄛𝄛𝄛𝄛𝄛𝄛𝄛𝄛𝄛𝄛𝄛𝄛𝄛𝄛𝄛𝄛𝄛𝄛𝄛𝄛𝄛𝄛𝄛𝄛𝄛𝄛𝄛
𝄛𝄛𝄛𝄛𝄛𝄛𝄛𝄛𝄛𝄛𝄛𝄛𝄛𝄛𝄛𝄛𝄛𝄛𝄛𝄛𝄛𝄛𝄛𝄛𝄛𝄛𝄛𝄛𝄛𝄛𝄛𝄛𝄛𝄛𝄛𝄛𝄛𝄛𝄛░░░░░░░░𝄛𝄛𝄛𝄛░░░░𝄛𝄛𝄛𝄛𝄛░░░░░░░░░𝄛𝄛𝄛𝄛░░░░░░░𝄛𝄛░░░░░░░░░░𝄛𝄛𝄛𝄛𝄛𝄛𝄛𝄛𝄛𝄛𝄛𝄛𝄛𝄛𝄛𝄛𝄛𝄛𝄛𝄛𝄛𝄛𝄛𝄛𝄛𝄛𝄛𝄛𝄛𝄛𝄛𝄛𝄛𝄛𝄛𝄛𝄛𝄛𝄛𝄛𝄛𝄛𝄛𝄛𝄛𝄛𝄛𝄛
𝄛𝄛𝄛𝄛𝄛𝄛𝄛𝄛𝄛𝄛𝄛𝄛𝄛𝄛𝄛𝄛𝄛𝄛𝄛𝄛𝄛𝄛𝄛𝄛𝄛𝄛𝄛𝄛𝄛𝄛𝄛𝄛𝄛𝄛𝄛𝄛𝄛░░░░░░░░░░𝄛𝄛𝄛𝄛░░░░░𝄛𝄛𝄛𝄛░░░░░░░░░𝄛𝄛𝄛𝄛░░░░░░░░░░░░░░░░░░𝄛𝄛𝄛𝄛𝄛𝄛𝄛𝄛𝄛𝄛𝄛𝄛𝄛𝄛𝄛𝄛𝄛𝄛𝄛𝄛𝄛𝄛𝄛𝄛𝄛𝄛𝄛𝄛𝄛𝄛𝄛𝄛𝄛𝄛𝄛𝄛𝄛𝄛𝄛𝄛𝄛𝄛𝄛𝄛𝄛𝄛𝄛𝄛𝄛
𝄛𝄛𝄛𝄛𝄛𝄛𝄛𝄛𝄛𝄛𝄛𝄛𝄛𝄛𝄛𝄛𝄛𝄛𝄛𝄛𝄛𝄛𝄛𝄛𝄛𝄛𝄛𝄛𝄛𝄛𝄛𝄛𝄛𝄛𝄛𝄛░░░░░░░░░░░𝄛𝄛𝄛𝄛░░░░░𝄛𝄛𝄛𝄛░░░░░░░░░░𝄛𝄛░░░░░░░░░░░░░░░░𝄛𝄛𝄛𝄛𝄛𝄛𝄛𝄛𝄛𝄛𝄛𝄛𝄛𝄛𝄛𝄛𝄛𝄛𝄛𝄛𝄛𝄛𝄛𝄛𝄛𝄛𝄛𝄛𝄛𝄛𝄛𝄛𝄛𝄛𝄛𝄛𝄛𝄛𝄛𝄛𝄛𝄛𝄛𝄛𝄛𝄛𝄛𝄛𝄛𝄛𝄛𝄛
𝄛𝄛𝄛𝄛𝄛𝄛𝄛𝄛𝄛𝄛𝄛𝄛𝄛𝄛𝄛𝄛𝄛𝄛𝄛𝄛𝄛𝄛𝄛𝄛𝄛𝄛𝄛𝄛𝄛𝄛𝄛𝄛𝄛𝄛𝄛𝄛░░░░░░░░░░░░░𝄛𝄛░░░░░𝄛𝄛𝄛𝄛░░░░░░░░░░░░░░░░░░░░░░░░░░░𝄛𝄛𝄛𝄛𝄛𝄛𝄛𝄛𝄛𝄛𝄛𝄛𝄛𝄛𝄛𝄛𝄛𝄛𝄛𝄛𝄛𝄛𝄛𝄛𝄛𝄛𝄛𝄛𝄛𝄛𝄛𝄛𝄛𝄛𝄛𝄛𝄛𝄛𝄛𝄛𝄛𝄛𝄛𝄛𝄛𝄛𝄛𝄛𝄛𝄛𝄛𝄛𝄛
𝄛𝄛𝄛𝄛𝄛𝄛𝄛𝄛𝄛𝄛𝄛𝄛𝄛𝄛𝄛𝄛𝄛𝄛𝄛𝄛𝄛𝄛𝄛𝄛𝄛𝄛𝄛𝄛𝄛𝄛𝄛𝄛𝄛𝄛𝄛𝄛░░░░░░░░░░░░░𝄛𝄛𝄛░░░𝄛𝄛𝄛𝄛𝄛░░░░░░░░░░░░░░░░░░░𝄛𝄛░░░░░░𝄛𝄛𝄛𝄛𝄛𝄛𝄛𝄛𝄛𝄛𝄛𝄛𝄛𝄛𝄛𝄛𝄛𝄛𝄛𝄛𝄛𝄛𝄛𝄛𝄛𝄛𝄛𝄛𝄛𝄛𝄛𝄛𝄛𝄛𝄛𝄛𝄛𝄛𝄛𝄛𝄛𝄛𝄛𝄛𝄛𝄛𝄛𝄛𝄛𝄛𝄛𝄛𝄛
𝄛𝄛𝄛𝄛𝄛𝄛𝄛𝄛𝄛𝄛𝄛𝄛𝄛𝄛𝄛𝄛𝄛𝄛𝄛𝄛𝄛𝄛𝄛𝄛𝄛𝄛𝄛𝄛𝄛𝄛𝄛𝄛𝄛𝄛𝄛░░░░░░░░░░░░░░░𝄛𝄛░░░𝄛𝄛𝄛𝄛𝄛𝄛░░░𝄛𝄛𝄛░░░░░░░░░░░𝄛𝄛𝄛𝄛░░░░░𝄛𝄛𝄛𝄛𝄛𝄛𝄛𝄛𝄛𝄛𝄛𝄛𝄛𝄛𝄛𝄛𝄛𝄛𝄛𝄛𝄛𝄛𝄛𝄛𝄛𝄛𝄛𝄛𝄛𝄛𝄛𝄛𝄛𝄛𝄛𝄛𝄛𝄛𝄛𝄛𝄛𝄛𝄛𝄛𝄛𝄛𝄛𝄛𝄛𝄛𝄛𝄛𝄛
𝄛𝄛𝄛𝄛𝄛𝄛𝄛𝄛𝄛𝄛𝄛𝄛𝄛𝄛𝄛𝄛𝄛𝄛𝄛𝄛𝄛𝄛𝄛𝄛𝄛𝄛𝄛𝄛𝄛𝄛𝄛𝄛𝄛𝄛𝄛░░░░░░░░░░░░░░░𝄛𝄛░░░𝄛𝄛𝄛𝄛𝄛𝄛░░𝄛𝄛𝄛𝄛𝄛░░░░░░░░░░𝄛𝄛𝄛𝄛░░░░𝄛𝄛𝄛𝄛𝄛𝄛𝄛𝄛𝄛𝄛𝄛𝄛𝄛𝄛𝄛𝄛𝄛𝄛𝄛𝄛𝄛𝄛𝄛𝄛𝄛𝄛𝄛𝄛𝄛𝄛𝄛𝄛𝄛𝄛𝄛𝄛𝄛𝄛𝄛𝄛𝄛𝄛𝄛𝄛𝄛𝄛𝄛𝄛𝄛𝄛𝄛𝄛𝄛𝄛
𝄛𝄛𝄛𝄛𝄛𝄛𝄛𝄛𝄛𝄛𝄛𝄛𝄛𝄛𝄛𝄛𝄛𝄛𝄛𝄛𝄛𝄛𝄛𝄛𝄛𝄛𝄛░░░𝄛𝄛𝄛𝄛░░░░░░░░░░░░░░░░𝄛𝄛𝄛░░░𝄛𝄛𝄛𝄛░░𝄛𝄛𝄛𝄛𝄛𝄛░░░░░░░░░░░𝄛𝄛░░░░𝄛𝄛𝄛𝄛𝄛𝄛𝄛𝄛𝄛𝄛𝄛𝄛𝄛𝄛𝄛𝄛𝄛𝄛𝄛𝄛𝄛𝄛𝄛𝄛𝄛𝄛𝄛𝄛𝄛𝄛𝄛𝄛𝄛𝄛𝄛𝄛𝄛𝄛𝄛𝄛𝄛𝄛𝄛𝄛𝄛𝄛𝄛𝄛𝄛𝄛𝄛𝄛𝄛𝄛𝄛
𝄛𝄛𝄛𝄛𝄛𝄛𝄛𝄛𝄛𝄛𝄛𝄛𝄛𝄛𝄛𝄛𝄛𝄛𝄛𝄛𝄛𝄛𝄛𝄛𝄛𝄛░░░░░𝄛𝄛𝄛░░░░░░░░░░░░░░░░𝄛𝄛𝄛░░░░𝄛𝄛░░░𝄛𝄛𝄛𝄛𝄛░░░░░░░░░░░░░░░░░𝄛𝄛𝄛𝄛𝄛𝄛𝄛𝄛𝄛𝄛𝄛𝄛𝄛𝄛𝄛𝄛𝄛𝄛𝄛𝄛𝄛𝄛𝄛𝄛𝄛𝄛𝄛𝄛𝄛𝄛𝄛𝄛𝄛𝄛𝄛𝄛𝄛𝄛𝄛𝄛𝄛𝄛𝄛𝄛𝄛𝄛𝄛𝄛𝄛𝄛𝄛𝄛𝄛𝄛𝄛𝄛
𝄛𝄛𝄛𝄛𝄛𝄛𝄛𝄛𝄛𝄛𝄛𝄛𝄛𝄛𝄛𝄛𝄛𝄛𝄛𝄛𝄛𝄛𝄛𝄛𝄛𝄛░░░░░𝄛𝄛𝄛░░░░░░░░░░░░░░░░𝄛𝄛𝄛𝄛░░░░░░░𝄛𝄛𝄛𝄛𝄛𝄛░░░░░░░░░░░░░░░░𝄛𝄛𝄛𝄛𝄛𝄛𝄛𝄛𝄛𝄛𝄛𝄛𝄛𝄛𝄛𝄛𝄛𝄛𝄛𝄛𝄛𝄛𝄛𝄛𝄛𝄛𝄛𝄛𝄛𝄛𝄛𝄛𝄛𝄛𝄛𝄛𝄛𝄛𝄛𝄛𝄛𝄛𝄛𝄛𝄛𝄛𝄛𝄛𝄛𝄛𝄛𝄛𝄛𝄛𝄛𝄛𝄛
𝄛𝄛𝄛𝄛𝄛𝄛𝄛𝄛𝄛𝄛𝄛𝄛𝄛𝄛𝄛𝄛𝄛𝄛𝄛𝄛𝄛𝄛𝄛𝄛𝄛𝄛𝄛░░░𝄛𝄛𝄛░░░░░░░░░░░░░░░░░░░░𝄛𝄛░░░░░𝄛𝄛𝄛𝄛𝄛𝄛𝄛𝄛░░░░░░░░░░░░░░░𝄛𝄛𝄛𝄛𝄛𝄛░░𝄛𝄛𝄛𝄛𝄛𝄛𝄛𝄛𝄛𝄛𝄛𝄛𝄛𝄛𝄛𝄛𝄛𝄛𝄛𝄛𝄛𝄛𝄛𝄛𝄛𝄛𝄛𝄛𝄛𝄛𝄛𝄛𝄛𝄛𝄛𝄛𝄛𝄛𝄛𝄛𝄛𝄛𝄛𝄛𝄛𝄛𝄛𝄛𝄛
𝄛𝄛𝄛𝄛𝄛𝄛𝄛𝄛𝄛𝄛𝄛𝄛𝄛𝄛𝄛𝄛𝄛𝄛𝄛𝄛𝄛𝄛𝄛𝄛𝄛𝄛𝄛𝄛𝄛𝄛𝄛𝄛░░░░░░░░░░░░░░░░░░░░░░𝄛𝄛░░𝄛𝄛𝄛𝄛𝄛𝄛𝄛𝄛𝄛𝄛𝄛░░░░░░░░░░░░░░░𝄛𝄛𝄛𝄛░░░░𝄛𝄛𝄛𝄛𝄛𝄛𝄛𝄛𝄛𝄛𝄛𝄛𝄛𝄛𝄛𝄛𝄛𝄛𝄛𝄛𝄛𝄛𝄛𝄛𝄛𝄛𝄛𝄛𝄛𝄛𝄛𝄛𝄛𝄛𝄛𝄛𝄛𝄛𝄛𝄛𝄛𝄛𝄛𝄛𝄛𝄛𝄛𝄛
𝄛𝄛𝄛𝄛𝄛𝄛𝄛𝄛𝄛𝄛𝄛𝄛𝄛𝄛𝄛𝄛𝄛𝄛𝄛𝄛𝄛𝄛𝄛𝄛𝄛𝄛𝄛𝄛𝄛𝄛𝄛░░░░░░░░░░░░░░░░░░░░░░░𝄛𝄛𝄛𝄛𝄛𝄛𝄛𝄛𝄛𝄛𝄛𝄛𝄛𝄛𝄛𝄛░░░░░░░░░░░░░░░𝄛𝄛𝄛░░░░░𝄛𝄛𝄛𝄛𝄛𝄛𝄛𝄛𝄛𝄛𝄛𝄛𝄛𝄛𝄛𝄛𝄛𝄛𝄛𝄛𝄛𝄛𝄛𝄛𝄛𝄛𝄛𝄛𝄛𝄛𝄛𝄛𝄛𝄛𝄛𝄛𝄛𝄛𝄛𝄛𝄛𝄛𝄛𝄛𝄛𝄛𝄛
𝄛𝄛𝄛𝄛𝄛𝄛𝄛𝄛𝄛𝄛𝄛𝄛𝄛𝄛𝄛𝄛𝄛𝄛𝄛𝄛𝄛𝄛𝄛𝄛𝄛𝄛𝄛𝄛𝄛𝄛𝄛░░░░░░░░░░░░░░░░░░░░░░𝄛𝄛𝄛𝄛𝄛𝄛░░░░░𝄛𝄛𝄛𝄛𝄛𝄛░░░░░░░░░░░░░░░░𝄛𝄛𝄛░░░░░𝄛𝄛𝄛𝄛𝄛𝄛𝄛𝄛𝄛𝄛𝄛𝄛𝄛𝄛𝄛𝄛𝄛𝄛𝄛𝄛𝄛𝄛𝄛𝄛𝄛𝄛𝄛𝄛𝄛𝄛𝄛𝄛𝄛𝄛𝄛𝄛𝄛𝄛𝄛𝄛𝄛𝄛𝄛𝄛𝄛𝄛
𝄛𝄛𝄛𝄛𝄛𝄛𝄛𝄛𝄛𝄛𝄛𝄛𝄛𝄛𝄛𝄛𝄛𝄛𝄛𝄛𝄛𝄛𝄛𝄛𝄛𝄛𝄛𝄛𝄛𝄛░░░░░░░░░░░░░░░░░░░░░░░░░𝄛𝄛░░░░░░░░░░𝄛𝄛░░░░░░░░░░░░░░░░░𝄛𝄛𝄛░░░░░𝄛𝄛𝄛𝄛𝄛𝄛𝄛𝄛𝄛𝄛𝄛𝄛𝄛𝄛𝄛𝄛𝄛𝄛𝄛𝄛𝄛𝄛𝄛𝄛𝄛𝄛𝄛𝄛𝄛𝄛𝄛𝄛𝄛𝄛𝄛𝄛𝄛𝄛𝄛𝄛𝄛𝄛𝄛𝄛𝄛𝄛
𝄛𝄛𝄛𝄛𝄛𝄛𝄛𝄛𝄛𝄛𝄛𝄛𝄛𝄛𝄛𝄛𝄛𝄛𝄛𝄛𝄛𝄛𝄛𝄛𝄛𝄛𝄛𝄛𝄛𝄛░░░░░░░░░░░░░░░░░░░░░░░░░░░░░░░░░░░░░░░░@░░░░░░░░░░░░░░𝄛𝄛𝄛𝄛𝄛░░░𝄛𝄛𝄛𝄛𝄛𝄛𝄛𝄛𝄛𝄛𝄛𝄛𝄛𝄛𝄛𝄛𝄛𝄛𝄛𝄛𝄛𝄛𝄛𝄛𝄛𝄛𝄛𝄛𝄛𝄛𝄛𝄛𝄛𝄛𝄛𝄛𝄛𝄛𝄛𝄛𝄛𝄛𝄛𝄛𝄛𝄛𝄛
𝄛𝄛𝄛𝄛𝄛𝄛𝄛𝄛𝄛𝄛𝄛𝄛𝄛𝄛𝄛𝄛𝄛𝄛𝄛𝄛𝄛𝄛𝄛𝄛𝄛𝄛𝄛𝄛𝄛𝄛░░░░░░░░░░░░░░░░░░░░░░░░░░░░░░░░░░░░░░░░░░░░░░░░░░░░░░░𝄛𝄛𝄛𝄛𝄛𝄛𝄛𝄛𝄛𝄛𝄛𝄛𝄛𝄛𝄛𝄛𝄛𝄛𝄛𝄛𝄛𝄛𝄛𝄛𝄛𝄛𝄛𝄛𝄛𝄛𝄛𝄛𝄛𝄛𝄛𝄛𝄛𝄛𝄛𝄛𝄛𝄛𝄛𝄛𝄛𝄛𝄛𝄛𝄛𝄛𝄛𝄛𝄛𝄛𝄛
𝄛𝄛𝄛𝄛𝄛𝄛𝄛𝄛𝄛𝄛𝄛𝄛𝄛𝄛𝄛𝄛𝄛𝄛𝄛𝄛𝄛𝄛𝄛𝄛𝄛𝄛𝄛𝄛𝄛𝄛░░░░░░░░░░░░░𝄛𝄛𝄛░░░░𝄛𝄛𝄛░░░░░░░░░░░░░░░░░░░░░░░░░░░░░░░░𝄛𝄛𝄛𝄛𝄛𝄛𝄛𝄛𝄛𝄛𝄛𝄛𝄛𝄛𝄛𝄛𝄛𝄛𝄛𝄛𝄛𝄛𝄛𝄛𝄛𝄛𝄛𝄛𝄛𝄛𝄛𝄛𝄛𝄛𝄛𝄛𝄛𝄛𝄛𝄛𝄛𝄛𝄛𝄛𝄛𝄛𝄛𝄛𝄛𝄛𝄛𝄛𝄛𝄛𝄛
𝄛𝄛𝄛𝄛𝄛𝄛𝄛𝄛𝄛𝄛𝄛𝄛𝄛𝄛𝄛𝄛𝄛𝄛𝄛𝄛𝄛𝄛𝄛𝄛░░░𝄛𝄛𝄛𝄛░░░░░░░░░░░░𝄛𝄛𝄛𝄛░░𝄛𝄛𝄛𝄛𝄛░░░░░░░░░░░░░░░░░░░𝄛𝄛░░░░░░░░░░𝄛𝄛𝄛𝄛𝄛𝄛𝄛𝄛𝄛𝄛𝄛𝄛𝄛𝄛𝄛𝄛𝄛𝄛𝄛𝄛𝄛𝄛𝄛𝄛𝄛𝄛𝄛𝄛𝄛𝄛𝄛𝄛𝄛𝄛𝄛𝄛𝄛𝄛𝄛𝄛𝄛𝄛𝄛𝄛𝄛𝄛𝄛𝄛𝄛𝄛𝄛𝄛𝄛𝄛𝄛
𝄛𝄛𝄛𝄛𝄛𝄛𝄛𝄛𝄛𝄛𝄛𝄛𝄛𝄛𝄛𝄛𝄛𝄛𝄛𝄛𝄛𝄛𝄛░░░░░𝄛𝄛𝄛𝄛░░░░░░░░░░░𝄛𝄛𝄛𝄛𝄛𝄛𝄛𝄛𝄛𝄛𝄛░░░░░░░░░░░░░░░░𝄛𝄛𝄛𝄛𝄛𝄛░░░░░░░░░░𝄛𝄛𝄛𝄛𝄛𝄛𝄛𝄛𝄛𝄛𝄛𝄛𝄛𝄛𝄛𝄛𝄛𝄛𝄛𝄛𝄛𝄛𝄛𝄛𝄛𝄛𝄛𝄛𝄛𝄛𝄛𝄛𝄛𝄛𝄛𝄛𝄛𝄛𝄛𝄛𝄛𝄛𝄛𝄛𝄛𝄛𝄛𝄛𝄛𝄛𝄛𝄛𝄛𝄛
𝄛𝄛𝄛𝄛𝄛𝄛𝄛𝄛𝄛𝄛𝄛𝄛𝄛𝄛𝄛𝄛𝄛𝄛𝄛𝄛𝄛𝄛𝄛░░░░░𝄛𝄛𝄛𝄛𝄛░░░░░░░░░𝄛𝄛𝄛𝄛𝄛𝄛𝄛𝄛𝄛𝄛𝄛░░░░░░░░░░░░░░░░𝄛𝄛𝄛𝄛𝄛𝄛𝄛𝄛░░░░░░░░░░░𝄛𝄛𝄛𝄛𝄛𝄛𝄛𝄛𝄛𝄛𝄛𝄛𝄛𝄛𝄛𝄛𝄛𝄛𝄛𝄛𝄛𝄛𝄛𝄛𝄛𝄛𝄛𝄛𝄛𝄛𝄛𝄛𝄛𝄛𝄛𝄛𝄛𝄛𝄛𝄛𝄛𝄛𝄛𝄛𝄛𝄛𝄛𝄛𝄛𝄛𝄛𝄛
𝄛𝄛𝄛𝄛𝄛𝄛𝄛𝄛𝄛𝄛𝄛𝄛𝄛𝄛𝄛𝄛𝄛𝄛𝄛𝄛𝄛𝄛𝄛░░░░░𝄛𝄛𝄛𝄛𝄛░░░░░░░░░𝄛𝄛𝄛𝄛𝄛𝄛𝄛𝄛𝄛𝄛░░░░░░░░░░░░░░░░𝄛𝄛𝄛𝄛𝄛𝄛𝄛𝄛𝄛░░░░░░░░░░░░𝄛𝄛𝄛𝄛𝄛𝄛𝄛𝄛𝄛𝄛𝄛𝄛𝄛𝄛𝄛𝄛𝄛𝄛𝄛𝄛𝄛𝄛𝄛𝄛𝄛𝄛𝄛𝄛𝄛𝄛𝄛𝄛𝄛𝄛𝄛𝄛𝄛𝄛𝄛𝄛𝄛𝄛𝄛𝄛𝄛𝄛𝄛𝄛𝄛𝄛𝄛
𝄛𝄛𝄛𝄛𝄛𝄛𝄛𝄛𝄛𝄛𝄛𝄛𝄛𝄛𝄛𝄛𝄛𝄛𝄛𝄛𝄛𝄛𝄛░░░░░𝄛𝄛𝄛𝄛░░░░░░░░░𝄛𝄛𝄛𝄛𝄛𝄛𝄛𝄛𝄛░░░░░░░░░░░░░░░░░░𝄛𝄛𝄛𝄛𝄛𝄛𝄛𝄛𝄛𝄛░░░░░░░░░░░𝄛𝄛𝄛𝄛𝄛𝄛𝄛𝄛𝄛𝄛𝄛𝄛𝄛𝄛𝄛𝄛𝄛𝄛𝄛𝄛𝄛𝄛𝄛𝄛𝄛𝄛𝄛𝄛𝄛𝄛𝄛𝄛𝄛𝄛𝄛𝄛𝄛𝄛𝄛𝄛𝄛𝄛𝄛𝄛𝄛𝄛𝄛𝄛𝄛𝄛𝄛
𝄛𝄛𝄛𝄛𝄛𝄛𝄛𝄛𝄛𝄛𝄛𝄛𝄛𝄛𝄛𝄛𝄛𝄛𝄛𝄛𝄛𝄛𝄛𝄛░░░░𝄛𝄛𝄛░░░░░░░░░░𝄛𝄛𝄛𝄛𝄛𝄛𝄛░░░░░░░░░░░░░░░░░░░░𝄛𝄛𝄛𝄛𝄛𝄛𝄛𝄛𝄛𝄛░░░░░░░░░░░𝄛𝄛𝄛𝄛𝄛░░𝄛𝄛𝄛𝄛𝄛𝄛𝄛𝄛𝄛𝄛𝄛𝄛𝄛𝄛𝄛𝄛𝄛𝄛𝄛𝄛𝄛𝄛𝄛𝄛𝄛𝄛𝄛𝄛𝄛𝄛𝄛𝄛𝄛𝄛𝄛𝄛𝄛𝄛𝄛𝄛𝄛𝄛𝄛𝄛
𝄛𝄛𝄛𝄛𝄛𝄛𝄛𝄛𝄛𝄛𝄛𝄛𝄛𝄛𝄛𝄛𝄛𝄛𝄛𝄛𝄛𝄛𝄛𝄛𝄛░░𝄛𝄛𝄛𝄛░░░░░░░░░░░𝄛𝄛𝄛░░░░░░░░░░░░░░░░░░░░░░░𝄛𝄛𝄛𝄛𝄛𝄛𝄛𝄛𝄛░░░░░░░░░░░░𝄛𝄛𝄛𝄛░░░░𝄛𝄛𝄛𝄛𝄛𝄛𝄛𝄛𝄛𝄛𝄛𝄛𝄛𝄛𝄛𝄛𝄛𝄛𝄛𝄛𝄛𝄛𝄛𝄛𝄛𝄛𝄛𝄛𝄛𝄛𝄛𝄛𝄛𝄛𝄛𝄛𝄛𝄛𝄛𝄛𝄛𝄛𝄛
𝄛𝄛𝄛𝄛𝄛𝄛𝄛𝄛𝄛𝄛𝄛𝄛𝄛𝄛𝄛𝄛𝄛𝄛𝄛𝄛𝄛𝄛𝄛𝄛𝄛𝄛𝄛𝄛𝄛𝄛𝄛░░░░░░░░░░░░░░░░░░░░░𝄛𝄛𝄛𝄛░░░░░░░░░░░𝄛𝄛𝄛𝄛𝄛𝄛𝄛𝄛𝄛░░░░░░░░░░░░░𝄛𝄛𝄛𝄛░░░░░𝄛𝄛𝄛𝄛𝄛𝄛𝄛𝄛𝄛𝄛𝄛𝄛𝄛𝄛𝄛𝄛𝄛𝄛𝄛𝄛𝄛𝄛𝄛𝄛𝄛𝄛𝄛𝄛𝄛𝄛𝄛𝄛𝄛𝄛𝄛𝄛𝄛𝄛𝄛𝄛𝄛𝄛
𝄛𝄛𝄛𝄛𝄛𝄛𝄛𝄛𝄛𝄛𝄛𝄛𝄛𝄛𝄛𝄛𝄛𝄛𝄛𝄛𝄛𝄛𝄛𝄛𝄛𝄛𝄛𝄛𝄛𝄛𝄛𝄛░░░░░░░░░░░░░░░░░░𝄛𝄛𝄛𝄛𝄛𝄛𝄛░░░░░░░░░𝄛𝄛𝄛𝄛𝄛𝄛𝄛𝄛𝄛░░░░░░░░░░░░░░░𝄛𝄛░░░░░░𝄛𝄛𝄛𝄛𝄛𝄛𝄛𝄛𝄛𝄛𝄛𝄛𝄛𝄛𝄛𝄛𝄛𝄛𝄛𝄛𝄛𝄛𝄛𝄛𝄛𝄛𝄛𝄛𝄛𝄛𝄛𝄛𝄛𝄛𝄛𝄛𝄛𝄛𝄛𝄛𝄛𝄛
𝄛𝄛𝄛𝄛𝄛𝄛𝄛𝄛𝄛𝄛𝄛𝄛𝄛𝄛𝄛𝄛𝄛𝄛𝄛𝄛𝄛𝄛𝄛𝄛𝄛𝄛𝄛𝄛𝄛𝄛𝄛𝄛𝄛░░░░░░░░░░░░░░𝄛𝄛𝄛𝄛𝄛𝄛𝄛𝄛𝄛𝄛𝄛𝄛░░░░𝄛𝄛𝄛𝄛𝄛𝄛𝄛𝄛𝄛░░░░░░░░░░░░░░░░░░░░░░░░░𝄛𝄛𝄛𝄛𝄛𝄛𝄛𝄛𝄛𝄛𝄛𝄛𝄛𝄛𝄛𝄛𝄛𝄛𝄛𝄛𝄛𝄛𝄛𝄛𝄛𝄛𝄛𝄛𝄛𝄛𝄛𝄛𝄛𝄛𝄛𝄛𝄛𝄛𝄛𝄛𝄛𝄛𝄛
𝄛𝄛𝄛𝄛𝄛𝄛𝄛𝄛𝄛𝄛𝄛𝄛𝄛𝄛𝄛𝄛𝄛𝄛𝄛𝄛𝄛𝄛𝄛𝄛𝄛𝄛𝄛𝄛𝄛𝄛𝄛𝄛𝄛░░░░░░░░░░░𝄛𝄛𝄛𝄛𝄛𝄛𝄛𝄛𝄛𝄛𝄛𝄛𝄛𝄛░░░░░░𝄛𝄛𝄛𝄛𝄛𝄛𝄛░░░░░░░░░░░░░░░░░░░░░░░░░░𝄛𝄛𝄛𝄛𝄛𝄛𝄛𝄛𝄛𝄛𝄛𝄛𝄛𝄛𝄛𝄛𝄛𝄛𝄛𝄛𝄛𝄛𝄛𝄛𝄛𝄛𝄛𝄛𝄛𝄛𝄛𝄛𝄛𝄛𝄛𝄛𝄛𝄛𝄛𝄛𝄛𝄛𝄛
𝄛𝄛𝄛𝄛𝄛𝄛𝄛𝄛𝄛𝄛𝄛𝄛𝄛𝄛𝄛𝄛𝄛𝄛𝄛𝄛𝄛𝄛𝄛𝄛𝄛𝄛░░𝄛𝄛𝄛𝄛𝄛░░░░░░░░░░𝄛𝄛𝄛𝄛𝄛𝄛░░░𝄛𝄛𝄛𝄛𝄛𝄛░░░░░░░░░░░░░░░░░░░░░░░░░░░░░░𝄛𝄛░░░░░░░𝄛𝄛𝄛𝄛𝄛𝄛𝄛𝄛𝄛𝄛𝄛𝄛𝄛𝄛𝄛𝄛𝄛𝄛𝄛𝄛𝄛𝄛𝄛𝄛𝄛𝄛𝄛𝄛𝄛𝄛𝄛𝄛𝄛𝄛𝄛𝄛𝄛𝄛𝄛𝄛𝄛𝄛𝄛
𝄛𝄛𝄛𝄛𝄛𝄛𝄛𝄛𝄛𝄛𝄛𝄛𝄛𝄛𝄛𝄛𝄛𝄛𝄛𝄛𝄛𝄛𝄛𝄛𝄛░░░░𝄛𝄛𝄛𝄛░░░░░░░░░░𝄛𝄛𝄛𝄛𝄛░░░░░𝄛𝄛𝄛𝄛░░░░░░░░░░░░░░░░░░░░░░░░░░░░░░𝄛𝄛𝄛𝄛░░░░░░𝄛𝄛𝄛𝄛𝄛𝄛𝄛𝄛𝄛𝄛𝄛𝄛𝄛𝄛𝄛𝄛𝄛𝄛𝄛𝄛𝄛𝄛𝄛𝄛𝄛𝄛𝄛𝄛𝄛𝄛𝄛𝄛𝄛𝄛𝄛𝄛𝄛𝄛𝄛𝄛𝄛𝄛𝄛
𝄛𝄛𝄛𝄛𝄛𝄛𝄛𝄛𝄛𝄛𝄛𝄛𝄛𝄛𝄛𝄛𝄛𝄛𝄛𝄛𝄛𝄛𝄛𝄛𝄛░░░░𝄛𝄛𝄛𝄛𝄛░░░░░░░░░𝄛𝄛𝄛𝄛𝄛░░░░░░░░░░░░░░░░░░░░░░░░░░░░░░░░░░░░░░░𝄛𝄛𝄛𝄛𝄛░░░░𝄛𝄛𝄛𝄛𝄛𝄛𝄛𝄛𝄛𝄛𝄛𝄛𝄛𝄛𝄛𝄛𝄛𝄛𝄛𝄛𝄛𝄛𝄛𝄛𝄛𝄛𝄛𝄛𝄛𝄛𝄛𝄛𝄛𝄛𝄛𝄛𝄛𝄛𝄛𝄛𝄛𝄛𝄛𝄛
𝄛𝄛𝄛𝄛𝄛𝄛𝄛𝄛𝄛𝄛𝄛𝄛𝄛𝄛𝄛𝄛𝄛𝄛𝄛𝄛𝄛𝄛𝄛𝄛𝄛𝄛░░░░𝄛𝄛𝄛░░░░░░░░░𝄛𝄛𝄛𝄛𝄛░░░░░░░░░░░░░░░░░░░░░░░░░░░░░░░░░░░░░░░𝄛𝄛𝄛𝄛𝄛𝄛𝄛𝄛𝄛𝄛𝄛𝄛𝄛𝄛𝄛𝄛𝄛𝄛𝄛𝄛𝄛𝄛𝄛𝄛𝄛𝄛𝄛𝄛𝄛𝄛𝄛𝄛𝄛𝄛𝄛𝄛𝄛𝄛𝄛𝄛𝄛𝄛𝄛𝄛𝄛𝄛𝄛𝄛𝄛𝄛𝄛𝄛𝄛𝄛
𝄛𝄛𝄛𝄛𝄛𝄛𝄛𝄛𝄛𝄛𝄛𝄛𝄛𝄛𝄛𝄛𝄛𝄛𝄛𝄛𝄛𝄛𝄛𝄛𝄛𝄛░░░░░░░░░░░░░░░𝄛𝄛𝄛𝄛𝄛░░░░░░░░░░░░░░░░░░░░░░░░░░░░░░░░░░░░𝄛𝄛𝄛𝄛𝄛𝄛𝄛𝄛𝄛𝄛𝄛𝄛𝄛𝄛𝄛𝄛𝄛𝄛𝄛𝄛𝄛𝄛𝄛𝄛𝄛𝄛𝄛𝄛𝄛𝄛𝄛𝄛𝄛𝄛𝄛𝄛𝄛𝄛𝄛𝄛𝄛𝄛𝄛𝄛𝄛𝄛𝄛𝄛𝄛𝄛𝄛𝄛𝄛𝄛𝄛𝄛𝄛𝄛
𝄛𝄛𝄛𝄛𝄛𝄛𝄛𝄛𝄛𝄛𝄛𝄛𝄛𝄛𝄛𝄛𝄛𝄛𝄛𝄛𝄛𝄛𝄛𝄛𝄛𝄛░░░░░░░░░░░░░░𝄛𝄛𝄛𝄛𝄛░░░░░░░░░░░░░░░░░░░░░░░░░░░░░░░░░░░░𝄛𝄛𝄛𝄛𝄛𝄛𝄛𝄛𝄛𝄛𝄛𝄛𝄛𝄛𝄛𝄛𝄛𝄛𝄛𝄛𝄛𝄛𝄛𝄛𝄛𝄛𝄛𝄛𝄛𝄛𝄛𝄛𝄛𝄛𝄛𝄛𝄛𝄛𝄛𝄛𝄛𝄛𝄛𝄛𝄛𝄛𝄛𝄛𝄛𝄛𝄛𝄛𝄛𝄛𝄛𝄛𝄛𝄛𝄛
𝄛𝄛𝄛𝄛𝄛𝄛𝄛𝄛𝄛𝄛𝄛𝄛𝄛𝄛𝄛𝄛𝄛𝄛𝄛𝄛𝄛𝄛𝄛𝄛𝄛𝄛░░░░░░░░░░░░░𝄛𝄛𝄛𝄛𝄛𝄛░░░░░░░░░░░░░░░░░░░░░░░░░░𝄛𝄛░░░░░░░░𝄛𝄛𝄛𝄛𝄛𝄛𝄛𝄛𝄛𝄛𝄛𝄛𝄛𝄛𝄛𝄛𝄛𝄛𝄛𝄛𝄛𝄛𝄛𝄛𝄛𝄛𝄛𝄛𝄛𝄛𝄛𝄛𝄛𝄛𝄛𝄛𝄛𝄛𝄛𝄛𝄛𝄛𝄛𝄛𝄛𝄛𝄛𝄛𝄛𝄛𝄛𝄛𝄛𝄛𝄛𝄛𝄛𝄛𝄛
𝄛𝄛𝄛𝄛𝄛𝄛𝄛𝄛𝄛𝄛𝄛𝄛𝄛𝄛𝄛𝄛𝄛𝄛𝄛𝄛𝄛𝄛𝄛𝄛𝄛𝄛𝄛░░𝄛𝄛𝄛𝄛░░░░░𝄛𝄛𝄛𝄛𝄛𝄛𝄛░░░░░░░░░░░░░░░░░░░░░░░░░𝄛𝄛𝄛𝄛░░░░░░░░𝄛𝄛𝄛𝄛𝄛𝄛░░░𝄛𝄛𝄛𝄛𝄛𝄛𝄛𝄛𝄛𝄛𝄛𝄛𝄛𝄛𝄛𝄛𝄛𝄛𝄛𝄛𝄛𝄛𝄛𝄛𝄛𝄛𝄛𝄛𝄛𝄛𝄛𝄛𝄛𝄛𝄛𝄛𝄛𝄛𝄛𝄛𝄛𝄛𝄛𝄛𝄛𝄛𝄛𝄛𝄛
