𝄛𝄛𝄛𝄛𝄛𝄛𝄛𝄛𝄛𝄛𝄛𝄛𝄛𝄛𝄛𝄛𝄛𝄛𝄛𝄛𝄛𝄛𝄛𝄛𝄛𝄛𝄛𝄛𝄛𝄛𝄛𝄛𝄛𝄛𝄛𝄛𝄛𝄛𝄛𝄛𝄛𝄛𝄛𝄛𝄛𝄛𝄛𝄛𝄛𝄛𝄛𝄛𝄛𝄛𝄛𝄛𝄛𝄛𝄛𝄛𝄛𝄛𝄛𝄛𝄛𝄛𝄛𝄛𝄛𝄛𝄛𝄛𝄛𝄛𝄛𝄛𝄛𝄛𝄛𝄛𝄛𝄛𝄛𝄛𝄛𝄛𝄛𝄛𝄛𝄛𝄛𝄛𝄛𝄛𝄛𝄛𝄛𝄛𝄛𝄛𝄛𝄛𝄛𝄛𝄛𝄛𝄛𝄛𝄛𝄛𝄛𝄛𝄛𝄛𝄛𝄛𝄛𝄛𝄛𝄛𝄛𝄛𝄛𝄛𝄛𝄛𝄛𝄛𝄛𝄛𝄛𝄛𝄛𝄛𝄛𝄛𝄛𝄛𝄛𝄛
𝄛𝄛𝄛𝄛𝄛𝄛𝄛𝄛𝄛𝄛𝄛𝄛𝄛𝄛𝄛𝄛𝄛𝄛𝄛𝄛𝄛𝄛𝄛𝄛𝄛𝄛𝄛𝄛𝄛𝄛𝄛𝄛𝄛𝄛𝄛𝄛𝄛𝄛𝄛𝄛𝄛𝄛𝄛𝄛𝄛𝄛𝄛𝄛𝄛𝄛𝄛𝄛𝄛𝄛𝄛𝄛𝄛𝄛𝄛𝄛𝄛𝄛𝄛𝄛𝄛𝄛𝄛𝄛𝄛𝄛𝄛𝄛𝄛𝄛𝄛𝄛𝄛𝄛𝄛𝄛𝄛𝄛𝄛𝄛𝄛𝄛𝄛𝄛𝄛𝄛𝄛𝄛𝄛𝄛𝄛𝄛𝄛𝄛𝄛𝄛𝄛𝄛𝄛𝄛𝄛𝄛𝄛𝄛𝄛𝄛𝄛𝄛𝄛𝄛𝄛𝄛𝄛𝄛𝄛𝄛𝄛𝄛𝄛𝄛𝄛𝄛𝄛𝄛𝄛𝄛𝄛𝄛𝄛𝄛𝄛𝄛𝄛𝄛𝄛𝄛
𝄛𝄛𝄛𝄛𝄛𝄛𝄛𝄛𝄛𝄛𝄛𝄛𝄛𝄛𝄛𝄛𝄛𝄛𝄛𝄛𝄛𝄛𝄛𝄛𝄛𝄛𝄛𝄛𝄛𝄛𝄛𝄛𝄛𝄛𝄛𝄛𝄛𝄛𝄛𝄛𝄛𝄛𝄛𝄛𝄛𝄛𝄛𝄛𝄛𝄛𝄛𝄛𝄛𝄛𝄛𝄛𝄛𝄛𝄛𝄛𝄛𝄛𝄛𝄛𝄛𝄛𝄛𝄛𝄛𝄛𝄛𝄛𝄛𝄛𝄛𝄛𝄛𝄛𝄛𝄛𝄛𝄛𝄛𝄛𝄛𝄛𝄛𝄛𝄛𝄛𝄛𝄛𝄛𝄛𝄛𝄛𝄛𝄛𝄛𝄛𝄛𝄛𝄛𝄛𝄛𝄛𝄛𝄛𝄛𝄛𝄛𝄛𝄛𝄛𝄛𝄛𝄛𝄛𝄛𝄛𝄛𝄛𝄛𝄛𝄛𝄛𝄛𝄛𝄛𝄛𝄛𝄛𝄛𝄛𝄛𝄛𝄛𝄛𝄛𝄛
𝄛𝄛𝄛𝄛𝄛𝄛𝄛𝄛𝄛𝄛𝄛𝄛𝄛𝄛𝄛𝄛𝄛𝄛𝄛𝄛𝄛𝄛𝄛𝄛𝄛𝄛𝄛𝄛𝄛𝄛𝄛𝄛𝄛𝄛𝄛𝄛𝄛𝄛𝄛𝄛𝄛𝄛𝄛𝄛𝄛𝄛𝄛𝄛𝄛𝄛𝄛𝄛𝄛𝄛𝄛𝄛𝄛𝄛𝄛𝄛𝄛𝄛𝄛𝄛𝄛𝄛𝄛𝄛𝄛𝄛𝄛𝄛𝄛𝄛𝄛𝄛𝄛𝄛𝄛𝄛𝄛𝄛𝄛𝄛𝄛𝄛𝄛𝄛𝄛𝄛𝄛𝄛𝄛𝄛𝄛𝄛𝄛𝄛𝄛𝄛𝄛𝄛𝄛𝄛𝄛𝄛𝄛𝄛𝄛𝄛𝄛𝄛𝄛𝄛𝄛𝄛𝄛𝄛𝄛𝄛𝄛𝄛𝄛𝄛𝄛𝄛𝄛𝄛𝄛𝄛𝄛𝄛𝄛𝄛𝄛𝄛𝄛𝄛𝄛𝄛
𝄛𝄛𝄛𝄛𝄛𝄛𝄛𝄛𝄛𝄛𝄛𝄛𝄛𝄛𝄛𝄛𝄛𝄛𝄛𝄛𝄛𝄛𝄛𝄛𝄛𝄛𝄛𝄛𝄛𝄛𝄛𝄛𝄛𝄛𝄛𝄛𝄛𝄛𝄛𝄛𝄛𝄛𝄛𝄛𝄛𝄛𝄛𝄛𝄛𝄛𝄛𝄛𝄛𝄛𝄛𝄛𝄛𝄛𝄛𝄛𝄛𝄛𝄛𝄛𝄛𝄛𝄛𝄛𝄛𝄛𝄛𝄛𝄛𝄛𝄛𝄛𝄛𝄛𝄛𝄛𝄛𝄛𝄛𝄛𝄛𝄛𝄛𝄛𝄛𝄛𝄛𝄛𝄛𝄛𝄛𝄛𝄛𝄛𝄛𝄛𝄛𝄛𝄛𝄛𝄛𝄛𝄛𝄛𝄛𝄛𝄛𝄛𝄛𝄛𝄛𝄛𝄛𝄛𝄛𝄛𝄛𝄛𝄛𝄛𝄛𝄛𝄛𝄛𝄛𝄛𝄛𝄛𝄛𝄛𝄛𝄛𝄛𝄛𝄛𝄛
𝄛𝄛𝄛𝄛𝄛𝄛𝄛𝄛𝄛𝄛𝄛𝄛𝄛𝄛𝄛𝄛𝄛𝄛𝄛𝄛𝄛𝄛𝄛𝄛𝄛𝄛𝄛𝄛𝄛𝄛𝄛𝄛𝄛𝄛𝄛𝄛𝄛𝄛𝄛𝄛𝄛𝄛𝄛𝄛𝄛𝄛𝄛𝄛𝄛𝄛𝄛𝄛𝄛𝄛𝄛𝄛𝄛𝄛𝄛𝄛𝄛𝄛𝄛𝄛𝄛𝄛𝄛𝄛𝄛𝄛𝄛𝄛𝄛𝄛𝄛𝄛𝄛𝄛𝄛𝄛𝄛𝄛𝄛𝄛𝄛𝄛𝄛𝄛𝄛𝄛𝄛𝄛𝄛𝄛𝄛𝄛𝄛𝄛𝄛𝄛𝄛𝄛𝄛𝄛𝄛𝄛𝄛𝄛𝄛𝄛𝄛𝄛𝄛𝄛𝄛𝄛𝄛𝄛𝄛𝄛𝄛𝄛𝄛𝄛𝄛𝄛𝄛𝄛𝄛𝄛𝄛𝄛𝄛𝄛𝄛𝄛𝄛𝄛𝄛𝄛
𝄛𝄛𝄛𝄛𝄛𝄛𝄛𝄛𝄛𝄛𝄛𝄛𝄛𝄛𝄛𝄛𝄛𝄛𝄛𝄛𝄛𝄛𝄛𝄛𝄛𝄛𝄛𝄛𝄛𝄛𝄛𝄛𝄛𝄛𝄛𝄛𝄛𝄛𝄛𝄛𝄛𝄛𝄛𝄛𝄛𝄛𝄛𝄛𝄛𝄛𝄛𝄛𝄛𝄛𝄛𝄛𝄛𝄛𝄛𝄛𝄛𝄛𝄛𝄛𝄛𝄛𝄛𝄛𝄛𝄛𝄛𝄛𝄛𝄛𝄛𝄛𝄛𝄛𝄛𝄛𝄛𝄛𝄛𝄛𝄛𝄛𝄛𝄛𝄛𝄛𝄛𝄛𝄛𝄛𝄛𝄛𝄛𝄛𝄛𝄛𝄛𝄛𝄛𝄛𝄛𝄛𝄛𝄛𝄛𝄛𝄛𝄛𝄛𝄛𝄛𝄛𝄛𝄛𝄛𝄛𝄛𝄛𝄛𝄛𝄛𝄛𝄛𝄛𝄛𝄛𝄛𝄛𝄛𝄛𝄛𝄛𝄛𝄛𝄛𝄛
𝄛𝄛𝄛𝄛𝄛𝄛𝄛𝄛𝄛𝄛𝄛𝄛𝄛𝄛𝄛𝄛𝄛𝄛𝄛𝄛𝄛𝄛𝄛𝄛𝄛𝄛𝄛𝄛𝄛𝄛𝄛𝄛𝄛𝄛𝄛𝄛𝄛𝄛𝄛𝄛𝄛𝄛𝄛𝄛𝄛𝄛𝄛𝄛𝄛𝄛𝄛𝄛𝄛𝄛𝄛𝄛𝄛𝄛𝄛𝄛𝄛𝄛𝄛𝄛𝄛𝄛𝄛𝄛𝄛𝄛𝄛𝄛𝄛𝄛𝄛𝄛𝄛𝄛𝄛𝄛𝄛𝄛𝄛𝄛𝄛𝄛𝄛𝄛𝄛𝄛𝄛𝄛𝄛𝄛𝄛𝄛𝄛𝄛𝄛𝄛𝄛𝄛𝄛𝄛𝄛𝄛𝄛𝄛𝄛𝄛𝄛𝄛𝄛𝄛𝄛𝄛𝄛𝄛𝄛𝄛𝄛𝄛𝄛𝄛𝄛𝄛𝄛𝄛𝄛𝄛𝄛𝄛𝄛𝄛𝄛𝄛𝄛𝄛𝄛𝄛
𝄛𝄛𝄛𝄛𝄛𝄛𝄛𝄛𝄛𝄛𝄛𝄛𝄛𝄛𝄛𝄛𝄛𝄛𝄛𝄛𝄛𝄛𝄛𝄛𝄛𝄛𝄛𝄛𝄛𝄛𝄛𝄛𝄛𝄛𝄛𝄛𝄛𝄛𝄛𝄛𝄛𝄛𝄛𝄛𝄛𝄛𝄛𝄛𝄛𝄛𝄛𝄛𝄛𝄛𝄛𝄛𝄛𝄛𝄛𝄛𝄛𝄛𝄛𝄛𝄛𝄛𝄛𝄛𝄛𝄛𝄛𝄛𝄛𝄛𝄛𝄛𝄛𝄛𝄛𝄛𝄛𝄛𝄛𝄛𝄛𝄛𝄛𝄛𝄛𝄛𝄛𝄛𝄛𝄛𝄛𝄛𝄛𝄛𝄛𝄛𝄛𝄛𝄛𝄛𝄛𝄛𝄛𝄛𝄛𝄛𝄛𝄛𝄛𝄛𝄛𝄛𝄛𝄛𝄛𝄛𝄛𝄛𝄛𝄛𝄛𝄛𝄛𝄛𝄛𝄛𝄛𝄛𝄛𝄛𝄛𝄛𝄛𝄛𝄛𝄛
𝄛𝄛𝄛𝄛𝄛𝄛𝄛𝄛𝄛𝄛𝄛𝄛𝄛𝄛𝄛𝄛𝄛𝄛𝄛𝄛𝄛𝄛𝄛𝄛𝄛𝄛𝄛𝄛𝄛𝄛𝄛𝄛𝄛𝄛𝄛𝄛𝄛𝄛𝄛𝄛𝄛𝄛𝄛𝄛𝄛𝄛𝄛𝄛𝄛𝄛𝄛𝄛𝄛𝄛𝄛𝄛𝄛𝄛𝄛𝄛𝄛𝄛𝄛𝄛𝄛𝄛𝄛𝄛𝄛𝄛𝄛𝄛𝄛𝄛𝄛𝄛𝄛𝄛𝄛𝄛𝄛𝄛𝄛𝄛𝄛𝄛𝄛𝄛𝄛𝄛𝄛𝄛𝄛𝄛𝄛𝄛𝄛𝄛𝄛𝄛𝄛𝄛𝄛𝄛𝄛𝄛𝄛𝄛𝄛𝄛𝄛𝄛𝄛𝄛𝄛𝄛𝄛𝄛𝄛𝄛𝄛𝄛𝄛𝄛𝄛𝄛𝄛𝄛𝄛𝄛𝄛𝄛𝄛𝄛𝄛𝄛𝄛𝄛𝄛𝄛
𝄛𝄛𝄛𝄛𝄛𝄛𝄛𝄛𝄛𝄛𝄛𝄛𝄛𝄛𝄛𝄛𝄛𝄛𝄛𝄛𝄛𝄛𝄛𝄛𝄛𝄛𝄛𝄛𝄛𝄛𝄛𝄛𝄛𝄛𝄛𝄛𝄛𝄛𝄛𝄛𝄛𝄛𝄛𝄛𝄛𝄛𝄛𝄛𝄛𝄛𝄛𝄛𝄛𝄛𝄛𝄛𝄛𝄛𝄛𝄛𝄛𝄛𝄛𝄛𝄛𝄛𝄛𝄛𝄛𝄛𝄛𝄛𝄛𝄛𝄛𝄛𝄛𝄛𝄛𝄛𝄛𝄛𝄛𝄛𝄛𝄛𝄛𝄛𝄛𝄛𝄛𝄛𝄛𝄛𝄛𝄛𝄛𝄛𝄛𝄛𝄛𝄛𝄛𝄛𝄛𝄛𝄛𝄛𝄛𝄛𝄛𝄛𝄛𝄛𝄛𝄛𝄛𝄛𝄛𝄛𝄛𝄛𝄛𝄛𝄛𝄛𝄛𝄛𝄛𝄛𝄛𝄛𝄛𝄛𝄛𝄛𝄛𝄛𝄛𝄛
𝄛𝄛𝄛𝄛𝄛𝄛𝄛𝄛𝄛𝄛𝄛𝄛𝄛𝄛𝄛𝄛𝄛𝄛𝄛𝄛𝄛𝄛𝄛𝄛𝄛𝄛𝄛𝄛𝄛𝄛𝄛𝄛𝄛𝄛𝄛𝄛𝄛𝄛𝄛𝄛𝄛𝄛𝄛𝄛𝄛𝄛𝄛𝄛𝄛𝄛𝄛𝄛𝄛𝄛𝄛𝄛𝄛𝄛𝄛𝄛𝄛𝄛𝄛𝄛𝄛𝄛𝄛𝄛𝄛𝄛𝄛𝄛𝄛𝄛𝄛𝄛𝄛𝄛𝄛𝄛𝄛𝄛𝄛𝄛𝄛𝄛𝄛𝄛𝄛𝄛𝄛𝄛𝄛𝄛𝄛𝄛𝄛𝄛𝄛𝄛𝄛𝄛𝄛𝄛𝄛𝄛𝄛𝄛𝄛𝄛𝄛𝄛𝄛𝄛𝄛𝄛𝄛𝄛𝄛𝄛𝄛𝄛𝄛𝄛𝄛𝄛𝄛𝄛𝄛𝄛𝄛𝄛𝄛𝄛𝄛𝄛𝄛𝄛𝄛𝄛
𝄛𝄛𝄛𝄛𝄛𝄛𝄛𝄛𝄛𝄛𝄛𝄛𝄛𝄛𝄛𝄛𝄛𝄛𝄛𝄛𝄛𝄛𝄛𝄛𝄛𝄛𝄛𝄛𝄛𝄛𝄛𝄛𝄛𝄛𝄛𝄛𝄛𝄛𝄛𝄛𝄛𝄛𝄛𝄛𝄛𝄛𝄛𝄛𝄛𝄛𝄛𝄛𝄛𝄛𝄛𝄛𝄛𝄛𝄛𝄛𝄛𝄛𝄛𝄛𝄛𝄛𝄛𝄛𝄛𝄛𝄛𝄛𝄛𝄛𝄛𝄛𝄛𝄛𝄛𝄛𝄛𝄛𝄛𝄛𝄛𝄛𝄛𝄛𝄛𝄛𝄛𝄛𝄛𝄛𝄛𝄛𝄛𝄛𝄛𝄛𝄛𝄛𝄛𝄛𝄛𝄛𝄛𝄛𝄛𝄛𝄛𝄛𝄛𝄛𝄛𝄛𝄛𝄛𝄛𝄛𝄛𝄛𝄛𝄛𝄛𝄛𝄛𝄛𝄛𝄛𝄛𝄛𝄛𝄛𝄛𝄛𝄛𝄛𝄛𝄛
𝄛𝄛𝄛𝄛𝄛𝄛𝄛𝄛𝄛𝄛𝄛𝄛𝄛𝄛𝄛𝄛𝄛𝄛𝄛𝄛𝄛𝄛𝄛𝄛𝄛𝄛𝄛𝄛𝄛𝄛𝄛𝄛𝄛𝄛𝄛𝄛𝄛𝄛𝄛𝄛𝄛𝄛𝄛𝄛𝄛𝄛𝄛𝄛𝄛𝄛𝄛𝄛𝄛𝄛𝄛𝄛𝄛𝄛𝄛𝄛𝄛𝄛𝄛𝄛𝄛𝄛𝄛𝄛𝄛𝄛𝄛𝄛𝄛𝄛𝄛𝄛𝄛𝄛𝄛𝄛𝄛𝄛𝄛𝄛𝄛𝄛𝄛𝄛𝄛𝄛𝄛𝄛𝄛𝄛𝄛𝄛𝄛𝄛𝄛𝄛𝄛𝄛𝄛𝄛𝄛𝄛𝄛𝄛𝄛𝄛𝄛𝄛𝄛𝄛𝄛𝄛𝄛𝄛𝄛𝄛𝄛𝄛𝄛𝄛𝄛𝄛𝄛𝄛𝄛𝄛𝄛𝄛𝄛𝄛𝄛𝄛𝄛𝄛𝄛𝄛
𝄛𝄛𝄛𝄛𝄛𝄛𝄛𝄛𝄛𝄛𝄛𝄛𝄛𝄛𝄛𝄛𝄛𝄛𝄛𝄛𝄛𝄛𝄛𝄛𝄛𝄛𝄛𝄛𝄛𝄛𝄛𝄛𝄛𝄛𝄛𝄛𝄛𝄛𝄛𝄛𝄛𝄛𝄛𝄛𝄛𝄛𝄛𝄛𝄛𝄛𝄛𝄛𝄛𝄛𝄛𝄛𝄛𝄛𝄛𝄛𝄛𝄛𝄛𝄛𝄛𝄛𝄛𝄛𝄛𝄛𝄛𝄛𝄛𝄛𝄛𝄛𝄛𝄛𝄛𝄛𝄛𝄛𝄛𝄛𝄛𝄛𝄛𝄛𝄛𝄛𝄛𝄛𝄛𝄛𝄛𝄛𝄛𝄛𝄛𝄛𝄛𝄛𝄛𝄛𝄛𝄛𝄛𝄛𝄛𝄛𝄛𝄛𝄛𝄛𝄛𝄛𝄛𝄛𝄛𝄛𝄛𝄛𝄛𝄛𝄛𝄛𝄛𝄛𝄛𝄛𝄛𝄛𝄛𝄛𝄛𝄛𝄛𝄛𝄛𝄛
𝄛𝄛𝄛𝄛𝄛𝄛𝄛𝄛𝄛𝄛𝄛𝄛𝄛𝄛𝄛𝄛𝄛𝄛𝄛𝄛𝄛𝄛𝄛𝄛𝄛𝄛𝄛𝄛𝄛𝄛𝄛𝄛𝄛𝄛𝄛𝄛𝄛𝄛𝄛𝄛𝄛𝄛𝄛𝄛𝄛𝄛𝄛𝄛𝄛𝄛𝄛𝄛𝄛𝄛𝄛𝄛𝄛𝄛𝄛𝄛𝄛𝄛𝄛𝄛𝄛𝄛𝄛𝄛𝄛𝄛𝄛𝄛𝄛𝄛𝄛𝄛𝄛𝄛𝄛𝄛𝄛𝄛𝄛𝄛𝄛𝄛𝄛𝄛𝄛𝄛𝄛𝄛𝄛𝄛𝄛𝄛𝄛𝄛𝄛𝄛𝄛𝄛𝄛𝄛𝄛𝄛𝄛𝄛𝄛𝄛𝄛𝄛𝄛𝄛𝄛𝄛𝄛𝄛𝄛𝄛𝄛𝄛𝄛𝄛𝄛𝄛𝄛𝄛𝄛𝄛𝄛𝄛𝄛𝄛𝄛𝄛𝄛𝄛𝄛𝄛
𝄛𝄛𝄛𝄛𝄛𝄛𝄛𝄛𝄛𝄛𝄛𝄛𝄛𝄛𝄛𝄛𝄛𝄛𝄛𝄛𝄛𝄛𝄛𝄛𝄛𝄛𝄛𝄛𝄛𝄛𝄛𝄛𝄛𝄛𝄛𝄛𝄛𝄛𝄛𝄛𝄛𝄛𝄛𝄛𝄛𝄛𝄛𝄛𝄛𝄛𝄛𝄛𝄛𝄛𝄛𝄛𝄛𝄛𝄛𝄛𝄛𝄛𝄛𝄛𝄛𝄛𝄛𝄛𝄛𝄛𝄛𝄛𝄛𝄛𝄛𝄛𝄛𝄛𝄛𝄛𝄛𝄛𝄛𝄛𝄛𝄛𝄛𝄛𝄛𝄛𝄛𝄛𝄛𝄛𝄛𝄛𝄛𝄛𝄛𝄛𝄛𝄛𝄛𝄛𝄛𝄛𝄛𝄛𝄛𝄛𝄛𝄛𝄛𝄛𝄛𝄛𝄛𝄛𝄛𝄛𝄛𝄛𝄛𝄛𝄛𝄛𝄛𝄛𝄛𝄛𝄛𝄛𝄛𝄛𝄛𝄛𝄛𝄛𝄛𝄛
𝄛𝄛𝄛𝄛𝄛𝄛𝄛𝄛𝄛𝄛𝄛𝄛𝄛𝄛𝄛𝄛𝄛𝄛𝄛𝄛𝄛𝄛𝄛𝄛𝄛𝄛𝄛𝄛𝄛𝄛𝄛𝄛𝄛𝄛𝄛𝄛𝄛𝄛𝄛𝄛𝄛𝄛𝄛𝄛𝄛𝄛𝄛𝄛𝄛𝄛𝄛𝄛𝄛𝄛𝄛𝄛𝄛𝄛𝄛𝄛𝄛𝄛𝄛𝄛𝄛𝄛𝄛𝄛𝄛𝄛𝄛𝄛𝄛𝄛𝄛𝄛𝄛𝄛𝄛𝄛𝄛𝄛𝄛𝄛𝄛𝄛𝄛𝄛𝄛𝄛𝄛𝄛𝄛𝄛𝄛𝄛𝄛𝄛𝄛𝄛𝄛𝄛𝄛𝄛𝄛𝄛𝄛𝄛𝄛𝄛𝄛𝄛𝄛𝄛𝄛𝄛𝄛𝄛𝄛𝄛𝄛𝄛𝄛𝄛𝄛𝄛𝄛𝄛𝄛𝄛𝄛𝄛𝄛𝄛𝄛𝄛𝄛𝄛𝄛𝄛
𝄛𝄛𝄛𝄛𝄛𝄛𝄛𝄛𝄛𝄛𝄛𝄛𝄛𝄛𝄛𝄛𝄛𝄛𝄛𝄛𝄛𝄛𝄛𝄛𝄛𝄛𝄛𝄛𝄛𝄛𝄛𝄛𝄛𝄛𝄛𝄛𝄛𝄛𝄛𝄛𝄛𝄛𝄛𝄛𝄛𝄛𝄛𝄛𝄛𝄛𝄛𝄛𝄛𝄛𝄛𝄛𝄛𝄛𝄛𝄛𝄛𝄛𝄛𝄛𝄛𝄛𝄛𝄛𝄛𝄛𝄛𝄛𝄛𝄛𝄛𝄛𝄛𝄛𝄛𝄛𝄛𝄛𝄛𝄛𝄛𝄛𝄛𝄛𝄛𝄛𝄛𝄛𝄛𝄛𝄛𝄛𝄛𝄛𝄛𝄛𝄛𝄛𝄛𝄛𝄛𝄛𝄛𝄛𝄛𝄛𝄛𝄛𝄛𝄛𝄛𝄛𝄛𝄛𝄛𝄛𝄛𝄛𝄛𝄛𝄛𝄛𝄛𝄛𝄛𝄛𝄛𝄛𝄛𝄛𝄛𝄛𝄛𝄛𝄛𝄛
𝄛𝄛𝄛𝄛𝄛𝄛𝄛𝄛𝄛𝄛𝄛𝄛𝄛𝄛𝄛𝄛𝄛𝄛𝄛𝄛𝄛𝄛𝄛𝄛𝄛𝄛𝄛𝄛𝄛𝄛𝄛𝄛𝄛𝄛𝄛𝄛𝄛𝄛𝄛𝄛𝄛𝄛𝄛𝄛𝄛𝄛𝄛𝄛𝄛𝄛𝄛𝄛𝄛𝄛𝄛𝄛𝄛𝄛𝄛𝄛𝄛𝄛𝄛𝄛𝄛𝄛𝄛𝄛𝄛𝄛𝄛𝄛𝄛𝄛𝄛𝄛𝄛𝄛𝄛𝄛𝄛𝄛𝄛𝄛𝄛𝄛𝄛𝄛𝄛𝄛𝄛𝄛𝄛𝄛𝄛𝄛𝄛𝄛𝄛𝄛𝄛𝄛𝄛𝄛𝄛𝄛𝄛𝄛𝄛𝄛𝄛𝄛𝄛𝄛𝄛𝄛𝄛𝄛𝄛𝄛𝄛𝄛𝄛𝄛𝄛𝄛𝄛𝄛𝄛𝄛𝄛𝄛𝄛𝄛𝄛𝄛𝄛𝄛𝄛𝄛
𝄛𝄛𝄛𝄛𝄛𝄛𝄛𝄛𝄛𝄛𝄛𝄛𝄛𝄛𝄛𝄛𝄛𝄛𝄛𝄛𝄛𝄛𝄛𝄛𝄛𝄛𝄛𝄛𝄛𝄛𝄛𝄛𝄛𝄛𝄛𝄛𝄛𝄛𝄛𝄛𝄛𝄛𝄛𝄛𝄛𝄛𝄛𝄛𝄛𝄛𝄛𝄛𝄛𝄛𝄛𝄛𝄛𝄛𝄛𝄛𝄛𝄛𝄛𝄛𝄛𝄛𝄛𝄛𝄛𝄛𝄛𝄛𝄛𝄛𝄛𝄛𝄛𝄛𝄛𝄛𝄛𝄛𝄛𝄛𝄛𝄛𝄛𝄛𝄛𝄛𝄛𝄛𝄛𝄛𝄛𝄛𝄛𝄛𝄛𝄛𝄛𝄛𝄛𝄛𝄛𝄛𝄛𝄛𝄛𝄛𝄛𝄛𝄛𝄛𝄛𝄛𝄛𝄛𝄛𝄛𝄛𝄛𝄛𝄛𝄛𝄛𝄛𝄛𝄛𝄛𝄛𝄛𝄛𝄛𝄛𝄛𝄛𝄛𝄛𝄛
𝄛𝄛𝄛𝄛𝄛𝄛𝄛𝄛𝄛𝄛𝄛𝄛𝄛𝄛𝄛𝄛𝄛𝄛𝄛𝄛𝄛𝄛𝄛𝄛𝄛𝄛𝄛𝄛𝄛𝄛𝄛𝄛𝄛𝄛𝄛𝄛𝄛𝄛𝄛𝄛𝄛𝄛𝄛𝄛𝄛𝄛𝄛𝄛𝄛𝄛𝄛𝄛𝄛𝄛𝄛𝄛𝄛𝄛𝄛𝄛𝄛𝄛𝄛𝄛𝄛𝄛𝄛𝄛𝄛𝄛𝄛𝄛𝄛𝄛𝄛𝄛𝄛𝄛𝄛𝄛𝄛𝄛𝄛𝄛𝄛𝄛𝄛𝄛𝄛𝄛𝄛𝄛𝄛𝄛𝄛𝄛𝄛𝄛𝄛𝄛𝄛𝄛𝄛𝄛𝄛𝄛𝄛𝄛𝄛𝄛𝄛𝄛𝄛𝄛𝄛𝄛𝄛𝄛𝄛𝄛𝄛𝄛𝄛𝄛𝄛𝄛𝄛𝄛𝄛𝄛𝄛𝄛𝄛𝄛𝄛𝄛𝄛𝄛𝄛𝄛
𝄛𝄛𝄛𝄛𝄛𝄛𝄛𝄛𝄛𝄛𝄛𝄛𝄛𝄛𝄛𝄛𝄛𝄛𝄛𝄛𝄛𝄛𝄛𝄛𝄛𝄛𝄛𝄛𝄛𝄛𝄛𝄛𝄛𝄛𝄛𝄛𝄛𝄛𝄛𝄛𝄛𝄛𝄛𝄛𝄛𝄛𝄛𝄛𝄛𝄛𝄛𝄛𝄛𝄛𝄛𝄛𝄛𝄛𝄛𝄛𝄛𝄛𝄛𝄛𝄛𝄛𝄛𝄛𝄛𝄛𝄛𝄛𝄛𝄛𝄛𝄛𝄛𝄛𝄛𝄛𝄛𝄛𝄛𝄛𝄛𝄛𝄛𝄛𝄛𝄛𝄛𝄛𝄛𝄛𝄛𝄛𝄛𝄛𝄛𝄛𝄛𝄛𝄛𝄛𝄛𝄛𝄛𝄛𝄛𝄛𝄛𝄛𝄛𝄛𝄛𝄛𝄛𝄛𝄛𝄛𝄛𝄛𝄛𝄛𝄛𝄛𝄛𝄛𝄛𝄛𝄛𝄛𝄛𝄛𝄛𝄛𝄛𝄛𝄛𝄛
𝄛𝄛𝄛𝄛𝄛𝄛𝄛𝄛𝄛𝄛𝄛𝄛𝄛𝄛𝄛𝄛𝄛𝄛𝄛𝄛𝄛𝄛𝄛𝄛𝄛░░░░░░░░░░░░░░░░░░░░░░░░░░░░░░░░░░░░░░░░░░░░░@░░░░𝄛𝄛𝄛𝄛𝄛𝄛𝄛𝄛𝄛𝄛𝄛𝄛𝄛𝄛𝄛𝄛𝄛𝄛𝄛𝄛𝄛𝄛𝄛𝄛𝄛𝄛𝄛𝄛𝄛𝄛𝄛𝄛𝄛𝄛𝄛𝄛𝄛𝄛𝄛𝄛𝄛𝄛𝄛𝄛𝄛𝄛𝄛𝄛𝄛𝄛𝄛𝄛𝄛𝄛𝄛𝄛𝄛𝄛𝄛𝄛𝄛𝄛𝄛𝄛𝄛
𝄛𝄛𝄛𝄛𝄛𝄛𝄛𝄛𝄛𝄛𝄛𝄛𝄛𝄛𝄛𝄛𝄛𝄛𝄛𝄛𝄛𝄛𝄛𝄛𝄛░░░░░░░░░░░░░░░░░░░░░░░░░░░░░░░░░░░░░░░░░░░░░░░░░░𝄛𝄛𝄛𝄛𝄛𝄛𝄛𝄛𝄛𝄛𝄛𝄛𝄛𝄛𝄛𝄛𝄛𝄛𝄛𝄛𝄛𝄛𝄛𝄛𝄛𝄛𝄛𝄛𝄛𝄛𝄛𝄛𝄛𝄛𝄛𝄛𝄛𝄛𝄛𝄛𝄛𝄛𝄛𝄛𝄛𝄛𝄛𝄛𝄛𝄛𝄛𝄛𝄛𝄛𝄛𝄛𝄛𝄛𝄛𝄛𝄛𝄛𝄛𝄛𝄛
𝄛𝄛𝄛𝄛𝄛𝄛𝄛𝄛𝄛𝄛𝄛𝄛𝄛𝄛𝄛𝄛𝄛𝄛𝄛𝄛𝄛𝄛𝄛𝄛𝄛░░░░░░░░░░░░░░░░░░░░░░░░░░░░░░░░░░░░░░░░░░░░░░░░░░𝄛𝄛𝄛𝄛𝄛𝄛𝄛𝄛𝄛𝄛𝄛𝄛𝄛𝄛𝄛𝄛𝄛𝄛𝄛𝄛𝄛𝄛𝄛𝄛𝄛𝄛𝄛𝄛𝄛𝄛𝄛𝄛𝄛𝄛𝄛𝄛𝄛𝄛𝄛𝄛𝄛𝄛𝄛𝄛𝄛𝄛𝄛𝄛𝄛𝄛𝄛𝄛𝄛𝄛𝄛𝄛𝄛𝄛𝄛𝄛𝄛𝄛𝄛𝄛𝄛
𝄛𝄛𝄛𝄛𝄛𝄛𝄛𝄛𝄛𝄛𝄛𝄛𝄛𝄛𝄛𝄛𝄛𝄛𝄛𝄛𝄛𝄛𝄛𝄛𝄛░░░░░░░░░░░░░░░░░░░░░░░░░░░░░░░░░░░░░░░░░░░░░░░░░░𝄛𝄛𝄛𝄛𝄛𝄛𝄛𝄛𝄛𝄛𝄛𝄛𝄛𝄛𝄛𝄛𝄛𝄛𝄛𝄛𝄛𝄛𝄛𝄛𝄛𝄛𝄛𝄛𝄛𝄛𝄛𝄛𝄛𝄛𝄛𝄛𝄛𝄛𝄛𝄛𝄛𝄛𝄛𝄛𝄛𝄛𝄛𝄛𝄛𝄛𝄛𝄛𝄛𝄛𝄛𝄛𝄛𝄛𝄛𝄛𝄛𝄛𝄛𝄛𝄛
𝄛𝄛𝄛𝄛𝄛𝄛𝄛𝄛𝄛𝄛𝄛𝄛𝄛𝄛𝄛𝄛𝄛𝄛𝄛𝄛𝄛𝄛𝄛𝄛𝄛░░░░░░░░░░░░░░░░░░░░░░░░░░░░░░░░░░░░░░░░░░░░░░░░░░𝄛𝄛𝄛𝄛𝄛𝄛𝄛𝄛𝄛𝄛𝄛𝄛𝄛𝄛𝄛𝄛𝄛𝄛𝄛𝄛𝄛𝄛𝄛𝄛𝄛𝄛𝄛𝄛𝄛𝄛𝄛𝄛𝄛𝄛𝄛𝄛𝄛𝄛𝄛𝄛𝄛𝄛𝄛𝄛𝄛𝄛𝄛𝄛𝄛𝄛𝄛𝄛𝄛𝄛𝄛𝄛𝄛𝄛𝄛𝄛𝄛𝄛𝄛𝄛𝄛
𝄛𝄛𝄛𝄛𝄛𝄛𝄛𝄛𝄛𝄛𝄛𝄛𝄛𝄛𝄛𝄛𝄛𝄛𝄛𝄛𝄛𝄛𝄛𝄛𝄛░░░░░░░░░░░░░░░░░░░░░░░░░░░░░░░░░░░░░░░░░░░░░░░░░░𝄛𝄛𝄛𝄛𝄛𝄛𝄛𝄛𝄛𝄛𝄛𝄛𝄛𝄛𝄛𝄛𝄛𝄛𝄛𝄛𝄛𝄛𝄛𝄛𝄛𝄛𝄛𝄛𝄛𝄛𝄛𝄛𝄛𝄛𝄛𝄛𝄛𝄛𝄛𝄛𝄛𝄛𝄛𝄛𝄛𝄛𝄛𝄛𝄛𝄛𝄛𝄛𝄛𝄛𝄛𝄛𝄛𝄛𝄛𝄛𝄛𝄛𝄛𝄛𝄛
𝄛𝄛𝄛𝄛𝄛𝄛𝄛𝄛𝄛𝄛𝄛𝄛𝄛𝄛𝄛𝄛𝄛𝄛𝄛𝄛𝄛𝄛𝄛𝄛𝄛░░░░░░░░░░░░░░░░░░░░░░░░░░░░░░░░░░░░░░░░░░░░░░░░░░𝄛𝄛𝄛𝄛𝄛𝄛𝄛𝄛𝄛𝄛𝄛𝄛𝄛𝄛𝄛𝄛𝄛𝄛𝄛𝄛𝄛𝄛𝄛𝄛𝄛𝄛𝄛𝄛𝄛𝄛𝄛𝄛𝄛𝄛𝄛𝄛𝄛𝄛𝄛𝄛𝄛𝄛𝄛𝄛𝄛𝄛𝄛𝄛𝄛𝄛𝄛𝄛𝄛𝄛𝄛𝄛𝄛𝄛𝄛𝄛𝄛𝄛𝄛𝄛𝄛
𝄛𝄛𝄛𝄛𝄛𝄛𝄛𝄛𝄛𝄛𝄛𝄛𝄛𝄛𝄛𝄛𝄛𝄛𝄛𝄛𝄛𝄛𝄛𝄛𝄛░░░░░░░░░░░░░░░░░░░░░░░░░░░░░░░░░░░░░░░░░░░░░░░░░░𝄛𝄛𝄛𝄛𝄛𝄛𝄛𝄛𝄛𝄛𝄛𝄛𝄛𝄛𝄛𝄛𝄛𝄛𝄛𝄛𝄛𝄛𝄛𝄛𝄛𝄛𝄛𝄛𝄛𝄛𝄛𝄛𝄛𝄛𝄛𝄛𝄛𝄛𝄛𝄛𝄛𝄛𝄛𝄛𝄛𝄛𝄛𝄛𝄛𝄛𝄛𝄛𝄛𝄛𝄛𝄛𝄛𝄛𝄛𝄛𝄛𝄛𝄛𝄛𝄛
𝄛𝄛𝄛𝄛𝄛𝄛𝄛𝄛𝄛𝄛𝄛𝄛𝄛𝄛𝄛𝄛𝄛𝄛𝄛𝄛𝄛𝄛𝄛𝄛𝄛░░░░░░░░░░░░░░░░░░░░░░░░░░░░░░░░░░░░░░░░░░░░░░░░░░𝄛𝄛𝄛𝄛𝄛𝄛𝄛𝄛𝄛𝄛𝄛𝄛𝄛𝄛𝄛𝄛𝄛𝄛𝄛𝄛𝄛𝄛𝄛𝄛𝄛𝄛𝄛𝄛𝄛𝄛𝄛𝄛𝄛𝄛𝄛𝄛𝄛𝄛𝄛𝄛𝄛𝄛𝄛𝄛𝄛𝄛𝄛𝄛𝄛𝄛𝄛𝄛𝄛𝄛𝄛𝄛𝄛𝄛𝄛𝄛𝄛𝄛𝄛𝄛𝄛
𝄛𝄛𝄛𝄛𝄛𝄛𝄛𝄛𝄛𝄛𝄛𝄛𝄛𝄛𝄛𝄛𝄛𝄛𝄛𝄛𝄛𝄛𝄛𝄛𝄛░░░░░░░░░░░░░░░░░░░░░░░░░░░░░░░░░░░░░░░░░░░░░░░░░░𝄛𝄛𝄛𝄛𝄛𝄛𝄛𝄛𝄛𝄛𝄛𝄛𝄛𝄛𝄛𝄛𝄛𝄛𝄛𝄛𝄛𝄛𝄛𝄛𝄛𝄛𝄛𝄛𝄛𝄛𝄛𝄛𝄛𝄛𝄛𝄛𝄛𝄛𝄛𝄛𝄛𝄛𝄛𝄛𝄛𝄛𝄛𝄛𝄛𝄛𝄛𝄛𝄛𝄛𝄛𝄛𝄛𝄛𝄛𝄛𝄛𝄛𝄛𝄛𝄛
𝄛𝄛𝄛𝄛𝄛𝄛𝄛𝄛𝄛𝄛𝄛𝄛𝄛𝄛𝄛𝄛𝄛𝄛𝄛𝄛𝄛𝄛𝄛𝄛𝄛░░░░░░░░░░░░░░░░░░░░░░░░░░░░░░░░░░░░░░░░░░░░░░░░░░𝄛𝄛𝄛𝄛𝄛𝄛𝄛𝄛𝄛𝄛𝄛𝄛𝄛𝄛𝄛𝄛𝄛𝄛𝄛𝄛𝄛𝄛𝄛𝄛𝄛𝄛𝄛𝄛𝄛𝄛𝄛𝄛𝄛𝄛𝄛𝄛𝄛𝄛𝄛𝄛𝄛𝄛𝄛𝄛𝄛𝄛𝄛𝄛𝄛𝄛𝄛𝄛𝄛𝄛𝄛𝄛𝄛𝄛𝄛𝄛𝄛𝄛𝄛𝄛𝄛
𝄛𝄛𝄛𝄛𝄛𝄛𝄛𝄛𝄛𝄛𝄛𝄛𝄛𝄛𝄛𝄛𝄛𝄛𝄛𝄛𝄛𝄛𝄛𝄛𝄛░░░░░░░░░░░░░░░░░░░░░░░░░░░░░░░░░░░░░░░░░░░░░░░░░░𝄛𝄛𝄛𝄛𝄛𝄛𝄛𝄛𝄛𝄛𝄛𝄛𝄛𝄛𝄛𝄛𝄛𝄛𝄛𝄛𝄛𝄛𝄛𝄛𝄛𝄛𝄛𝄛𝄛𝄛𝄛𝄛𝄛𝄛𝄛𝄛𝄛𝄛𝄛𝄛𝄛𝄛𝄛𝄛𝄛𝄛𝄛𝄛𝄛𝄛𝄛𝄛𝄛𝄛𝄛𝄛𝄛𝄛𝄛𝄛𝄛𝄛𝄛𝄛𝄛
𝄛𝄛𝄛𝄛𝄛𝄛𝄛𝄛𝄛𝄛𝄛𝄛𝄛𝄛𝄛𝄛𝄛𝄛𝄛𝄛𝄛𝄛𝄛𝄛𝄛░░░░░░░░░░░░░░░░░░░░░░░░░░░░░░░░░░░░░░░░░░░░░░░░░░𝄛𝄛𝄛𝄛𝄛𝄛𝄛𝄛𝄛𝄛𝄛𝄛𝄛𝄛𝄛𝄛𝄛𝄛𝄛𝄛𝄛𝄛𝄛𝄛𝄛𝄛𝄛𝄛𝄛𝄛𝄛𝄛𝄛𝄛𝄛𝄛𝄛𝄛𝄛𝄛𝄛𝄛𝄛𝄛𝄛𝄛𝄛𝄛𝄛𝄛𝄛𝄛𝄛𝄛𝄛𝄛𝄛𝄛𝄛𝄛𝄛𝄛𝄛𝄛𝄛
𝄛𝄛𝄛𝄛𝄛𝄛𝄛𝄛𝄛𝄛𝄛𝄛𝄛𝄛𝄛𝄛𝄛𝄛𝄛𝄛𝄛𝄛𝄛𝄛𝄛░░░░░░░░░░░░░░░░░░░░░░░░░░░░░░░░░░░░░░░░░░░░░░░░░░𝄛𝄛𝄛𝄛𝄛𝄛𝄛𝄛𝄛𝄛𝄛𝄛𝄛𝄛𝄛𝄛𝄛𝄛𝄛𝄛𝄛𝄛𝄛𝄛𝄛𝄛𝄛𝄛𝄛𝄛𝄛𝄛𝄛𝄛𝄛𝄛𝄛𝄛𝄛𝄛𝄛𝄛𝄛𝄛𝄛𝄛𝄛𝄛𝄛𝄛𝄛𝄛𝄛𝄛𝄛𝄛𝄛𝄛𝄛𝄛𝄛𝄛𝄛𝄛𝄛
𝄛𝄛𝄛𝄛𝄛𝄛𝄛𝄛𝄛𝄛𝄛𝄛𝄛𝄛𝄛𝄛𝄛𝄛𝄛𝄛𝄛𝄛𝄛𝄛𝄛░░░░░░░░░░░░░░░░░░░░░░░░░░░░░░░░░░░░░░░░░░░░░░░░░░𝄛𝄛𝄛𝄛𝄛𝄛𝄛𝄛𝄛𝄛𝄛𝄛𝄛𝄛𝄛𝄛𝄛𝄛𝄛𝄛𝄛𝄛𝄛𝄛𝄛𝄛𝄛𝄛𝄛𝄛𝄛𝄛𝄛𝄛𝄛𝄛𝄛𝄛𝄛𝄛𝄛𝄛𝄛𝄛𝄛𝄛𝄛𝄛𝄛𝄛𝄛𝄛𝄛𝄛𝄛𝄛𝄛𝄛𝄛𝄛𝄛𝄛𝄛𝄛𝄛
𝄛𝄛𝄛𝄛𝄛𝄛𝄛𝄛𝄛𝄛𝄛𝄛𝄛𝄛𝄛𝄛𝄛𝄛𝄛𝄛𝄛𝄛𝄛𝄛𝄛░░░░░░░░░░░░░░░░░░░░░░░░░░░░░░░░░░░░░░░░░░░░░░░░░░𝄛𝄛𝄛𝄛𝄛𝄛𝄛𝄛𝄛𝄛𝄛𝄛𝄛𝄛𝄛𝄛𝄛𝄛𝄛𝄛𝄛𝄛𝄛𝄛𝄛𝄛𝄛𝄛𝄛𝄛𝄛𝄛𝄛𝄛𝄛𝄛𝄛𝄛𝄛𝄛𝄛𝄛𝄛𝄛𝄛𝄛𝄛𝄛𝄛𝄛𝄛𝄛𝄛𝄛𝄛𝄛𝄛𝄛𝄛𝄛𝄛𝄛𝄛𝄛𝄛
𝄛𝄛𝄛𝄛𝄛𝄛𝄛𝄛𝄛𝄛𝄛𝄛𝄛𝄛𝄛𝄛𝄛𝄛𝄛𝄛𝄛𝄛𝄛𝄛𝄛░░░░░░░░░░░░░░░░░░░░░░░░░░░░░░░░░░░░░░░░░░░░░░░░░░𝄛𝄛𝄛𝄛𝄛𝄛𝄛𝄛𝄛𝄛𝄛𝄛𝄛𝄛𝄛𝄛𝄛𝄛𝄛𝄛𝄛𝄛𝄛𝄛𝄛𝄛𝄛𝄛𝄛𝄛𝄛𝄛𝄛𝄛𝄛𝄛𝄛𝄛𝄛𝄛𝄛𝄛𝄛𝄛𝄛𝄛𝄛𝄛𝄛𝄛𝄛𝄛𝄛𝄛𝄛𝄛𝄛𝄛𝄛𝄛𝄛𝄛𝄛𝄛𝄛
𝄛𝄛𝄛𝄛𝄛𝄛𝄛𝄛𝄛𝄛𝄛𝄛𝄛𝄛𝄛𝄛𝄛𝄛𝄛𝄛𝄛𝄛𝄛𝄛𝄛░░░░░░░░░░░░░░░░░ ░░░░░░░░░░░░░░░░░░░░░░░░░░░░░░░░𝄛𝄛𝄛𝄛𝄛𝄛𝄛𝄛𝄛𝄛𝄛𝄛𝄛𝄛𝄛𝄛𝄛𝄛𝄛𝄛𝄛𝄛𝄛𝄛𝄛𝄛𝄛𝄛𝄛𝄛𝄛𝄛𝄛𝄛𝄛𝄛𝄛𝄛𝄛𝄛𝄛𝄛𝄛𝄛𝄛𝄛𝄛𝄛𝄛𝄛𝄛𝄛𝄛𝄛𝄛𝄛𝄛𝄛𝄛𝄛𝄛𝄛𝄛𝄛𝄛
𝄛𝄛𝄛𝄛𝄛𝄛𝄛𝄛𝄛𝄛𝄛𝄛𝄛𝄛𝄛𝄛𝄛𝄛𝄛𝄛𝄛𝄛𝄛𝄛𝄛░░░░░░░░░░░░░░░[33m▓(B[m░░[36m▓(B[m░░░░░░░░░░░░░░░░░░░░░░░░░░░░░░░𝄛𝄛𝄛𝄛𝄛𝄛𝄛𝄛𝄛𝄛𝄛𝄛𝄛𝄛𝄛𝄛𝄛𝄛𝄛𝄛𝄛𝄛𝄛𝄛𝄛𝄛𝄛𝄛𝄛𝄛𝄛𝄛𝄛𝄛𝄛𝄛𝄛𝄛𝄛𝄛𝄛𝄛𝄛𝄛𝄛𝄛𝄛𝄛𝄛𝄛𝄛𝄛𝄛𝄛𝄛𝄛𝄛𝄛𝄛𝄛𝄛𝄛𝄛𝄛𝄛
𝄛𝄛𝄛𝄛𝄛𝄛𝄛𝄛𝄛𝄛𝄛𝄛𝄛𝄛𝄛𝄛𝄛𝄛𝄛𝄛𝄛𝄛𝄛𝄛𝄛░░░░░░░░░░░░░░░░░░░░░░░░░░░░░░░░░░░░░░░░░░░░░░░░░░𝄛𝄛𝄛𝄛𝄛𝄛𝄛𝄛𝄛𝄛𝄛𝄛𝄛𝄛𝄛𝄛𝄛𝄛𝄛𝄛𝄛𝄛𝄛𝄛𝄛𝄛𝄛𝄛𝄛𝄛𝄛𝄛𝄛𝄛𝄛𝄛𝄛𝄛𝄛𝄛𝄛𝄛𝄛𝄛𝄛𝄛𝄛𝄛𝄛𝄛𝄛𝄛𝄛𝄛𝄛𝄛𝄛𝄛𝄛𝄛𝄛𝄛𝄛𝄛𝄛
𝄛𝄛𝄛𝄛𝄛𝄛𝄛𝄛𝄛𝄛𝄛𝄛𝄛𝄛𝄛𝄛𝄛𝄛𝄛𝄛𝄛𝄛𝄛𝄛𝄛░░░░░░░░░░░░░░░░░░░░[32m▮(B[m░░░░░░░░░░░░░░░░[31m░(B[m[31m[31m[31m[31m[31m░(B[m(B[m(B[m(B[m(B[m[31m[31m░(B[m(B[m░[31m[31m[31m[31m[31m░(B[m(B[m(B[m(B[m(B[m[31m[31m[31m[31m░(B[m(B[m(B[m(B[m░░░░░░░𝄛𝄛𝄛𝄛𝄛𝄛𝄛𝄛𝄛𝄛𝄛𝄛𝄛𝄛𝄛𝄛𝄛𝄛𝄛𝄛𝄛𝄛𝄛𝄛𝄛𝄛𝄛𝄛𝄛𝄛𝄛𝄛𝄛𝄛𝄛𝄛𝄛𝄛𝄛𝄛𝄛𝄛𝄛𝄛𝄛𝄛𝄛𝄛𝄛𝄛𝄛𝄛𝄛𝄛𝄛𝄛𝄛𝄛𝄛𝄛𝄛𝄛𝄛𝄛𝄛
𝄛𝄛𝄛𝄛𝄛𝄛𝄛𝄛𝄛𝄛𝄛𝄛𝄛𝄛𝄛𝄛𝄛𝄛𝄛𝄛𝄛𝄛𝄛𝄛𝄛░░░░░░░░░░░░░░░░░░░░░░░░░░░░░░░░░░[31m░(B[m[31m░(B[m░[31m░(B[m[31m[31m░(B[m(B[m[31m░(B[m[31m[31m░(B[m(B[m[31m[31m[31m[31m[31m░(B[m(B[m(B[m(B[m(B[m[31m[31m░(B[m(B[m░░░░░░░𝄛𝄛𝄛𝄛𝄛𝄛𝄛𝄛𝄛𝄛𝄛𝄛𝄛𝄛𝄛𝄛𝄛𝄛𝄛𝄛𝄛𝄛𝄛𝄛𝄛𝄛𝄛𝄛𝄛𝄛𝄛𝄛𝄛𝄛𝄛𝄛𝄛𝄛𝄛𝄛𝄛𝄛𝄛𝄛𝄛𝄛𝄛𝄛𝄛𝄛𝄛𝄛𝄛𝄛𝄛𝄛𝄛𝄛𝄛𝄛𝄛𝄛𝄛𝄛𝄛
