𝄛𝄛𝄛𝄛𝄛𝄛𝄛𝄛𝄛𝄛𝄛𝄛𝄛𝄛𝄛𝄛𝄛𝄛𝄛𝄛𝄛░░░░░░░░░𝄛𝄛𝄛𝄛𝄛𝄛𝄛𝄛𝄛𝄛𝄛𝄛𝄛𝄛𝄛𝄛░░░░░░░░░𝄛𝄛𝄛𝄛𝄛𝄛𝄛𝄛𝄛𝄛𝄛𝄛𝄛𝄛𝄛𝄛𝄛𝄛𝄛𝄛𝄛𝄛𝄛𝄛𝄛𝄛𝄛𝄛𝄛𝄛𝄛𝄛𝄛𝄛𝄛𝄛𝄛𝄛𝄛𝄛𝄛𝄛𝄛𝄛𝄛𝄛𝄛𝄛𝄛𝄛𝄛𝄛𝄛𝄛𝄛𝄛𝄛𝄛𝄛𝄛𝄛𝄛𝄛𝄛𝄛𝄛𝄛𝄛𝄛𝄛𝄛𝄛𝄛𝄛𝄛𝄛𝄛𝄛𝄛𝄛𝄛𝄛𝄛𝄛𝄛
𝄛𝄛𝄛𝄛𝄛𝄛𝄛𝄛𝄛𝄛𝄛𝄛𝄛𝄛𝄛𝄛𝄛𝄛𝄛𝄛𝄛𝄛░░░░░░░░𝄛𝄛𝄛𝄛𝄛𝄛𝄛𝄛𝄛𝄛𝄛𝄛𝄛𝄛𝄛░░░░░░░░░𝄛𝄛𝄛𝄛𝄛𝄛𝄛𝄛𝄛𝄛𝄛𝄛𝄛𝄛𝄛𝄛𝄛𝄛𝄛𝄛𝄛𝄛𝄛𝄛𝄛𝄛𝄛𝄛𝄛𝄛𝄛𝄛𝄛𝄛𝄛𝄛𝄛𝄛𝄛𝄛𝄛𝄛𝄛𝄛𝄛𝄛𝄛𝄛𝄛𝄛𝄛𝄛𝄛𝄛𝄛𝄛𝄛𝄛𝄛𝄛𝄛𝄛𝄛𝄛𝄛𝄛𝄛𝄛𝄛𝄛𝄛𝄛𝄛𝄛𝄛𝄛𝄛𝄛𝄛𝄛𝄛𝄛𝄛𝄛𝄛𝄛
𝄛𝄛𝄛𝄛𝄛𝄛𝄛𝄛𝄛𝄛𝄛𝄛𝄛𝄛𝄛𝄛𝄛𝄛𝄛𝄛𝄛𝄛𝄛░░░░░░░𝄛𝄛𝄛𝄛𝄛𝄛𝄛𝄛𝄛𝄛𝄛𝄛𝄛𝄛░░░░░░░░░𝄛𝄛𝄛𝄛𝄛𝄛𝄛𝄛𝄛𝄛𝄛𝄛𝄛𝄛𝄛𝄛𝄛𝄛𝄛𝄛𝄛𝄛𝄛𝄛𝄛𝄛𝄛𝄛𝄛𝄛𝄛𝄛𝄛𝄛𝄛𝄛𝄛𝄛𝄛𝄛𝄛𝄛𝄛𝄛𝄛𝄛𝄛𝄛𝄛𝄛𝄛𝄛𝄛𝄛𝄛𝄛𝄛𝄛𝄛𝄛𝄛𝄛𝄛𝄛𝄛𝄛𝄛𝄛𝄛𝄛𝄛𝄛𝄛𝄛𝄛𝄛𝄛𝄛𝄛𝄛𝄛𝄛𝄛𝄛𝄛𝄛𝄛
𝄛𝄛𝄛𝄛𝄛𝄛𝄛𝄛𝄛𝄛𝄛𝄛𝄛𝄛𝄛𝄛𝄛𝄛𝄛𝄛𝄛𝄛𝄛░░░░░░░░𝄛𝄛𝄛𝄛𝄛𝄛𝄛𝄛𝄛𝄛𝄛𝄛𝄛░░░░░░░░𝄛𝄛𝄛𝄛𝄛𝄛𝄛𝄛𝄛𝄛𝄛𝄛𝄛𝄛𝄛𝄛𝄛𝄛𝄛𝄛𝄛𝄛𝄛𝄛𝄛𝄛𝄛𝄛𝄛𝄛𝄛𝄛𝄛𝄛𝄛𝄛𝄛𝄛𝄛𝄛𝄛𝄛𝄛𝄛𝄛𝄛𝄛𝄛𝄛𝄛𝄛𝄛𝄛𝄛𝄛𝄛𝄛𝄛𝄛𝄛𝄛𝄛𝄛𝄛𝄛𝄛𝄛𝄛𝄛𝄛𝄛𝄛𝄛𝄛𝄛𝄛𝄛𝄛𝄛𝄛𝄛𝄛𝄛𝄛𝄛𝄛𝄛𝄛
𝄛𝄛𝄛𝄛𝄛𝄛𝄛𝄛𝄛𝄛𝄛𝄛𝄛𝄛𝄛𝄛𝄛𝄛𝄛𝄛𝄛𝄛𝄛░░░░░░░░𝄛𝄛𝄛𝄛𝄛𝄛𝄛𝄛𝄛𝄛𝄛░░░░░░░░░𝄛𝄛𝄛𝄛𝄛𝄛𝄛𝄛𝄛𝄛𝄛𝄛𝄛𝄛𝄛𝄛𝄛𝄛𝄛𝄛𝄛𝄛𝄛𝄛𝄛𝄛𝄛𝄛𝄛𝄛𝄛𝄛𝄛𝄛𝄛𝄛𝄛𝄛𝄛𝄛𝄛𝄛𝄛𝄛𝄛𝄛𝄛𝄛𝄛𝄛𝄛𝄛𝄛𝄛𝄛𝄛𝄛𝄛𝄛𝄛𝄛𝄛𝄛𝄛𝄛𝄛𝄛𝄛𝄛𝄛𝄛𝄛𝄛𝄛𝄛𝄛𝄛𝄛𝄛𝄛𝄛𝄛𝄛𝄛𝄛𝄛𝄛𝄛𝄛
𝄛𝄛𝄛𝄛𝄛𝄛𝄛𝄛𝄛𝄛𝄛𝄛𝄛𝄛𝄛𝄛𝄛𝄛𝄛𝄛𝄛𝄛𝄛𝄛░░░░░░░░𝄛𝄛𝄛𝄛𝄛𝄛░░░░░░░░░░░░░░░░░░𝄛𝄛𝄛𝄛𝄛𝄛𝄛𝄛𝄛𝄛𝄛𝄛𝄛𝄛𝄛𝄛𝄛𝄛𝄛𝄛𝄛𝄛𝄛𝄛𝄛𝄛𝄛𝄛𝄛𝄛𝄛𝄛𝄛𝄛𝄛𝄛𝄛𝄛𝄛𝄛𝄛𝄛𝄛𝄛𝄛𝄛𝄛𝄛𝄛𝄛𝄛𝄛𝄛𝄛𝄛𝄛𝄛𝄛𝄛𝄛𝄛𝄛𝄛𝄛𝄛𝄛𝄛𝄛𝄛𝄛𝄛𝄛𝄛𝄛𝄛𝄛𝄛𝄛𝄛𝄛𝄛𝄛𝄛𝄛
𝄛𝄛𝄛𝄛𝄛𝄛𝄛𝄛𝄛𝄛𝄛𝄛𝄛𝄛𝄛𝄛𝄛𝄛𝄛𝄛𝄛𝄛𝄛𝄛░░░░░░░░░░░░░░░░░░░░░░░░░░░░░░░░░░░░𝄛𝄛𝄛𝄛𝄛𝄛𝄛𝄛𝄛𝄛𝄛𝄛𝄛𝄛𝄛𝄛𝄛𝄛𝄛𝄛𝄛𝄛𝄛𝄛𝄛𝄛𝄛𝄛𝄛𝄛𝄛𝄛𝄛𝄛𝄛𝄛𝄛𝄛𝄛𝄛𝄛𝄛𝄛𝄛𝄛𝄛𝄛𝄛𝄛𝄛𝄛𝄛𝄛𝄛𝄛𝄛𝄛𝄛𝄛𝄛𝄛𝄛𝄛𝄛𝄛𝄛𝄛𝄛𝄛𝄛𝄛𝄛𝄛𝄛𝄛𝄛𝄛𝄛𝄛𝄛
𝄛𝄛𝄛𝄛𝄛𝄛𝄛𝄛𝄛𝄛𝄛𝄛𝄛𝄛𝄛𝄛𝄛𝄛𝄛𝄛𝄛𝄛𝄛𝄛𝄛░░░░░░░░░░░░░░░░░░░𝄛𝄛𝄛░░░░░░░░░░░░░░░░░░𝄛𝄛𝄛𝄛𝄛𝄛𝄛𝄛𝄛𝄛𝄛𝄛𝄛𝄛𝄛𝄛𝄛𝄛𝄛𝄛𝄛𝄛𝄛𝄛𝄛𝄛𝄛𝄛𝄛𝄛𝄛𝄛𝄛𝄛𝄛𝄛𝄛𝄛𝄛𝄛𝄛𝄛𝄛𝄛𝄛𝄛𝄛𝄛𝄛𝄛𝄛𝄛𝄛𝄛𝄛𝄛𝄛𝄛𝄛𝄛𝄛𝄛𝄛𝄛𝄛𝄛𝄛𝄛𝄛𝄛𝄛𝄛𝄛𝄛𝄛
𝄛𝄛𝄛𝄛𝄛𝄛𝄛𝄛𝄛𝄛𝄛𝄛𝄛𝄛𝄛𝄛𝄛𝄛𝄛𝄛𝄛𝄛𝄛𝄛𝄛░░░░░░░░░░░░░░░𝄛𝄛𝄛𝄛𝄛𝄛𝄛𝄛𝄛𝄛𝄛𝄛𝄛𝄛░░░░░░░░░░░░𝄛𝄛𝄛𝄛𝄛𝄛𝄛𝄛𝄛𝄛𝄛𝄛𝄛𝄛𝄛𝄛𝄛𝄛𝄛𝄛𝄛𝄛𝄛𝄛𝄛𝄛𝄛𝄛𝄛𝄛𝄛𝄛𝄛𝄛𝄛𝄛𝄛𝄛𝄛𝄛𝄛𝄛𝄛𝄛𝄛𝄛𝄛𝄛𝄛𝄛𝄛𝄛𝄛𝄛𝄛𝄛𝄛𝄛𝄛𝄛𝄛𝄛𝄛𝄛𝄛𝄛𝄛𝄛𝄛𝄛𝄛𝄛𝄛𝄛
𝄛𝄛𝄛𝄛𝄛𝄛𝄛𝄛𝄛𝄛𝄛𝄛𝄛𝄛𝄛𝄛𝄛𝄛𝄛𝄛𝄛𝄛𝄛𝄛𝄛𝄛░░░░░░░░░𝄛𝄛𝄛𝄛𝄛𝄛𝄛𝄛𝄛𝄛𝄛𝄛𝄛𝄛𝄛𝄛𝄛𝄛𝄛𝄛𝄛𝄛𝄛░░░░░░░░░𝄛𝄛𝄛𝄛𝄛𝄛𝄛𝄛𝄛𝄛𝄛𝄛𝄛𝄛𝄛𝄛𝄛𝄛𝄛𝄛𝄛𝄛𝄛𝄛𝄛𝄛𝄛𝄛𝄛𝄛𝄛𝄛𝄛𝄛𝄛𝄛𝄛𝄛𝄛𝄛𝄛𝄛𝄛𝄛𝄛𝄛𝄛𝄛𝄛𝄛𝄛𝄛𝄛𝄛𝄛𝄛𝄛𝄛𝄛𝄛𝄛𝄛𝄛𝄛𝄛𝄛𝄛𝄛𝄛𝄛𝄛𝄛𝄛
𝄛𝄛𝄛𝄛𝄛𝄛𝄛𝄛𝄛𝄛𝄛𝄛𝄛𝄛𝄛𝄛𝄛𝄛𝄛𝄛𝄛𝄛𝄛𝄛𝄛𝄛𝄛░░░░░░░░░𝄛𝄛𝄛𝄛𝄛𝄛𝄛𝄛𝄛𝄛𝄛𝄛𝄛𝄛𝄛𝄛𝄛𝄛𝄛𝄛𝄛𝄛𝄛𝄛░░░░░░░░𝄛𝄛𝄛𝄛𝄛𝄛𝄛𝄛𝄛𝄛𝄛𝄛𝄛𝄛𝄛𝄛𝄛𝄛𝄛𝄛𝄛𝄛𝄛𝄛𝄛𝄛𝄛𝄛𝄛𝄛𝄛𝄛𝄛𝄛𝄛𝄛𝄛𝄛𝄛𝄛𝄛𝄛𝄛𝄛𝄛𝄛𝄛𝄛𝄛𝄛𝄛𝄛𝄛𝄛𝄛𝄛𝄛𝄛𝄛𝄛𝄛𝄛𝄛𝄛𝄛𝄛𝄛𝄛𝄛𝄛𝄛𝄛
𝄛𝄛𝄛𝄛𝄛𝄛𝄛𝄛𝄛𝄛𝄛𝄛𝄛𝄛𝄛𝄛𝄛𝄛𝄛𝄛𝄛𝄛𝄛𝄛𝄛𝄛𝄛𝄛░░░░░░░░𝄛𝄛𝄛𝄛𝄛𝄛𝄛𝄛𝄛𝄛𝄛𝄛𝄛𝄛𝄛𝄛𝄛𝄛𝄛𝄛𝄛𝄛𝄛𝄛░░░░░░░░░𝄛𝄛𝄛𝄛𝄛𝄛𝄛𝄛𝄛𝄛𝄛𝄛𝄛𝄛𝄛𝄛𝄛𝄛𝄛𝄛𝄛𝄛𝄛𝄛𝄛𝄛𝄛𝄛𝄛𝄛𝄛𝄛𝄛𝄛𝄛𝄛𝄛𝄛𝄛𝄛𝄛𝄛𝄛𝄛𝄛𝄛𝄛𝄛𝄛𝄛𝄛𝄛𝄛𝄛𝄛𝄛𝄛𝄛𝄛𝄛𝄛𝄛𝄛𝄛𝄛𝄛𝄛𝄛𝄛𝄛𝄛
𝄛𝄛𝄛𝄛𝄛𝄛𝄛𝄛𝄛𝄛𝄛𝄛𝄛𝄛𝄛𝄛𝄛𝄛𝄛𝄛𝄛𝄛𝄛𝄛𝄛𝄛𝄛𝄛𝄛░░░░░░░𝄛𝄛𝄛𝄛𝄛𝄛𝄛𝄛𝄛𝄛𝄛𝄛𝄛𝄛𝄛𝄛𝄛𝄛𝄛𝄛𝄛𝄛𝄛𝄛𝄛░░░░░░░░░𝄛𝄛𝄛𝄛𝄛𝄛𝄛𝄛𝄛𝄛𝄛𝄛𝄛𝄛𝄛𝄛𝄛𝄛𝄛𝄛𝄛𝄛𝄛𝄛𝄛𝄛𝄛𝄛𝄛𝄛𝄛𝄛𝄛𝄛𝄛𝄛𝄛𝄛𝄛𝄛𝄛𝄛𝄛𝄛𝄛𝄛𝄛𝄛𝄛𝄛𝄛𝄛𝄛𝄛𝄛𝄛𝄛𝄛𝄛𝄛𝄛𝄛𝄛𝄛𝄛𝄛𝄛𝄛𝄛𝄛
𝄛𝄛𝄛𝄛𝄛𝄛𝄛𝄛𝄛𝄛𝄛𝄛𝄛𝄛𝄛𝄛𝄛𝄛𝄛𝄛𝄛𝄛𝄛𝄛𝄛𝄛𝄛𝄛𝄛𝄛░░░░░░𝄛𝄛𝄛𝄛𝄛𝄛𝄛𝄛𝄛𝄛𝄛𝄛𝄛𝄛𝄛𝄛𝄛𝄛𝄛𝄛𝄛𝄛𝄛𝄛𝄛𝄛░░░░░░░░░𝄛𝄛𝄛𝄛𝄛𝄛𝄛𝄛𝄛𝄛𝄛𝄛𝄛𝄛𝄛𝄛𝄛𝄛𝄛𝄛𝄛𝄛𝄛𝄛𝄛𝄛𝄛𝄛𝄛𝄛𝄛𝄛𝄛𝄛𝄛𝄛𝄛𝄛𝄛𝄛𝄛𝄛𝄛𝄛𝄛𝄛𝄛𝄛𝄛𝄛𝄛𝄛𝄛𝄛𝄛𝄛𝄛𝄛𝄛𝄛𝄛𝄛𝄛𝄛𝄛𝄛𝄛𝄛𝄛
𝄛𝄛𝄛𝄛𝄛𝄛𝄛𝄛𝄛𝄛𝄛𝄛𝄛𝄛𝄛𝄛𝄛𝄛𝄛𝄛𝄛𝄛𝄛𝄛𝄛𝄛𝄛𝄛𝄛𝄛𝄛░░░░░𝄛𝄛𝄛𝄛𝄛𝄛𝄛𝄛𝄛𝄛𝄛𝄛𝄛𝄛𝄛𝄛𝄛𝄛𝄛𝄛𝄛𝄛𝄛𝄛𝄛𝄛𝄛░░░░░░░░░𝄛𝄛𝄛𝄛𝄛𝄛𝄛𝄛𝄛𝄛𝄛𝄛𝄛𝄛𝄛𝄛𝄛𝄛𝄛𝄛𝄛𝄛𝄛𝄛𝄛𝄛𝄛𝄛𝄛𝄛𝄛𝄛𝄛𝄛𝄛𝄛𝄛𝄛𝄛𝄛𝄛𝄛𝄛𝄛𝄛𝄛𝄛𝄛𝄛𝄛𝄛𝄛𝄛𝄛𝄛𝄛𝄛𝄛𝄛𝄛𝄛𝄛𝄛𝄛𝄛𝄛𝄛𝄛
𝄛𝄛𝄛𝄛𝄛𝄛𝄛𝄛𝄛𝄛𝄛𝄛𝄛𝄛𝄛𝄛𝄛𝄛𝄛𝄛𝄛𝄛𝄛𝄛𝄛𝄛𝄛𝄛𝄛𝄛𝄛𝄛𝄛░░░𝄛𝄛𝄛𝄛𝄛𝄛𝄛𝄛𝄛𝄛𝄛𝄛𝄛𝄛𝄛𝄛𝄛𝄛𝄛𝄛𝄛𝄛𝄛𝄛𝄛𝄛𝄛𝄛░░░░░░░░░𝄛𝄛𝄛𝄛𝄛𝄛𝄛𝄛𝄛𝄛𝄛𝄛𝄛𝄛𝄛𝄛𝄛𝄛𝄛𝄛𝄛𝄛𝄛𝄛𝄛𝄛𝄛𝄛𝄛𝄛𝄛𝄛𝄛𝄛𝄛𝄛𝄛𝄛𝄛𝄛𝄛𝄛𝄛𝄛𝄛𝄛𝄛𝄛𝄛𝄛𝄛𝄛𝄛𝄛𝄛𝄛𝄛𝄛𝄛𝄛𝄛𝄛𝄛𝄛𝄛𝄛𝄛
𝄛𝄛𝄛𝄛𝄛𝄛𝄛𝄛𝄛𝄛𝄛𝄛𝄛𝄛𝄛𝄛𝄛𝄛𝄛𝄛𝄛𝄛𝄛𝄛𝄛𝄛𝄛𝄛𝄛𝄛𝄛𝄛𝄛░░░░𝄛𝄛𝄛𝄛𝄛𝄛𝄛𝄛𝄛𝄛𝄛𝄛𝄛𝄛𝄛𝄛𝄛𝄛𝄛𝄛𝄛𝄛𝄛𝄛𝄛𝄛𝄛𝄛░░░░░░░░░𝄛𝄛𝄛𝄛𝄛𝄛𝄛𝄛░░░░░𝄛𝄛𝄛𝄛𝄛𝄛𝄛𝄛𝄛𝄛𝄛𝄛𝄛𝄛𝄛𝄛𝄛𝄛𝄛𝄛𝄛𝄛𝄛𝄛𝄛𝄛𝄛𝄛𝄛𝄛𝄛𝄛𝄛𝄛𝄛𝄛𝄛𝄛𝄛𝄛𝄛𝄛𝄛𝄛𝄛𝄛𝄛𝄛𝄛𝄛𝄛𝄛𝄛
𝄛𝄛𝄛𝄛𝄛𝄛𝄛𝄛𝄛𝄛𝄛𝄛𝄛𝄛𝄛𝄛𝄛𝄛𝄛𝄛𝄛𝄛𝄛𝄛𝄛𝄛𝄛𝄛𝄛𝄛𝄛𝄛𝄛░░░░𝄛𝄛𝄛𝄛𝄛𝄛𝄛𝄛𝄛𝄛𝄛𝄛𝄛𝄛𝄛𝄛𝄛𝄛𝄛𝄛𝄛𝄛𝄛𝄛𝄛𝄛𝄛𝄛𝄛░░░░░░░░𝄛𝄛𝄛𝄛𝄛𝄛░░░░░░░░░𝄛𝄛𝄛𝄛𝄛𝄛𝄛𝄛𝄛𝄛𝄛𝄛𝄛𝄛𝄛𝄛𝄛𝄛𝄛𝄛𝄛𝄛𝄛𝄛𝄛𝄛𝄛𝄛𝄛𝄛𝄛𝄛𝄛𝄛𝄛𝄛𝄛𝄛𝄛𝄛𝄛𝄛𝄛𝄛𝄛𝄛𝄛𝄛𝄛𝄛𝄛
𝄛𝄛𝄛𝄛𝄛𝄛𝄛𝄛𝄛𝄛𝄛𝄛𝄛𝄛𝄛𝄛𝄛𝄛𝄛𝄛𝄛𝄛𝄛𝄛𝄛𝄛𝄛𝄛𝄛𝄛𝄛𝄛𝄛𝄛░░░𝄛𝄛𝄛𝄛𝄛𝄛𝄛𝄛𝄛𝄛𝄛𝄛𝄛𝄛𝄛𝄛𝄛𝄛𝄛𝄛𝄛𝄛𝄛𝄛𝄛𝄛𝄛𝄛𝄛𝄛░░░░░░░░𝄛𝄛𝄛░░░░░░░░░░░░░𝄛𝄛𝄛𝄛𝄛𝄛𝄛𝄛𝄛𝄛𝄛𝄛𝄛𝄛𝄛𝄛𝄛𝄛𝄛𝄛𝄛𝄛𝄛𝄛𝄛𝄛𝄛𝄛𝄛𝄛𝄛𝄛𝄛𝄛𝄛𝄛𝄛𝄛𝄛𝄛𝄛𝄛𝄛𝄛𝄛𝄛𝄛𝄛𝄛
𝄛𝄛𝄛𝄛𝄛𝄛𝄛𝄛𝄛𝄛𝄛𝄛𝄛𝄛𝄛𝄛𝄛𝄛𝄛𝄛𝄛𝄛𝄛𝄛𝄛𝄛𝄛𝄛𝄛𝄛𝄛𝄛𝄛𝄛░░░𝄛𝄛𝄛𝄛𝄛𝄛𝄛𝄛𝄛𝄛𝄛𝄛𝄛𝄛𝄛𝄛𝄛𝄛𝄛𝄛𝄛𝄛𝄛𝄛𝄛𝄛𝄛𝄛𝄛𝄛░░░░░░░░░𝄛𝄛░░░░░░░░░░░░░𝄛𝄛𝄛𝄛𝄛𝄛𝄛𝄛𝄛𝄛𝄛𝄛𝄛𝄛𝄛𝄛𝄛𝄛𝄛𝄛𝄛𝄛𝄛𝄛𝄛𝄛𝄛𝄛𝄛𝄛𝄛𝄛𝄛𝄛𝄛𝄛𝄛𝄛𝄛𝄛𝄛𝄛𝄛𝄛𝄛𝄛𝄛𝄛𝄛
𝄛𝄛𝄛𝄛𝄛𝄛𝄛𝄛𝄛𝄛𝄛𝄛𝄛𝄛𝄛𝄛𝄛𝄛𝄛𝄛𝄛𝄛𝄛𝄛𝄛𝄛𝄛𝄛𝄛𝄛𝄛𝄛𝄛𝄛░░░░𝄛𝄛𝄛𝄛𝄛𝄛𝄛𝄛𝄛𝄛𝄛𝄛𝄛𝄛𝄛𝄛𝄛𝄛𝄛𝄛𝄛𝄛𝄛𝄛𝄛𝄛𝄛𝄛𝄛𝄛░░░░░░░░░░░░░░░░░░░░░░░░𝄛𝄛𝄛𝄛𝄛𝄛𝄛𝄛𝄛𝄛𝄛𝄛𝄛𝄛𝄛𝄛𝄛𝄛𝄛𝄛𝄛𝄛𝄛𝄛𝄛𝄛𝄛𝄛𝄛𝄛𝄛𝄛𝄛𝄛𝄛𝄛𝄛𝄛𝄛𝄛𝄛𝄛𝄛𝄛𝄛𝄛𝄛𝄛
𝄛𝄛𝄛𝄛𝄛𝄛𝄛𝄛𝄛𝄛𝄛𝄛𝄛𝄛𝄛𝄛𝄛𝄛𝄛𝄛𝄛𝄛𝄛𝄛𝄛𝄛𝄛𝄛𝄛𝄛𝄛𝄛𝄛𝄛░░░░𝄛𝄛𝄛𝄛𝄛𝄛𝄛𝄛𝄛𝄛𝄛𝄛𝄛𝄛𝄛𝄛𝄛𝄛𝄛𝄛𝄛𝄛𝄛𝄛𝄛𝄛𝄛𝄛𝄛░░░░░░░░░░░░░░░░░░░░░░░░░𝄛𝄛𝄛𝄛𝄛𝄛𝄛𝄛𝄛𝄛𝄛𝄛𝄛𝄛𝄛𝄛𝄛𝄛𝄛𝄛𝄛𝄛𝄛𝄛𝄛𝄛𝄛𝄛𝄛𝄛𝄛𝄛𝄛𝄛𝄛𝄛𝄛𝄛𝄛𝄛𝄛𝄛𝄛𝄛𝄛𝄛𝄛𝄛
𝄛𝄛𝄛𝄛𝄛𝄛𝄛𝄛𝄛𝄛𝄛𝄛𝄛𝄛𝄛𝄛𝄛𝄛𝄛𝄛𝄛𝄛𝄛𝄛𝄛𝄛𝄛𝄛𝄛𝄛𝄛𝄛𝄛𝄛𝄛░░░𝄛𝄛𝄛𝄛𝄛𝄛𝄛𝄛𝄛𝄛𝄛𝄛𝄛𝄛𝄛𝄛𝄛𝄛𝄛𝄛𝄛𝄛𝄛𝄛𝄛𝄛𝄛𝄛𝄛░░░░░░░░░░░░░░░░░░░░░░░░░𝄛𝄛𝄛𝄛𝄛𝄛𝄛𝄛𝄛𝄛𝄛𝄛𝄛𝄛𝄛𝄛𝄛𝄛𝄛𝄛𝄛𝄛𝄛𝄛𝄛𝄛𝄛𝄛𝄛𝄛𝄛𝄛𝄛𝄛𝄛𝄛𝄛𝄛𝄛𝄛𝄛𝄛𝄛𝄛𝄛𝄛𝄛𝄛
𝄛𝄛𝄛𝄛𝄛𝄛𝄛𝄛𝄛𝄛𝄛𝄛𝄛𝄛𝄛𝄛𝄛𝄛𝄛𝄛𝄛𝄛𝄛𝄛𝄛𝄛𝄛𝄛𝄛𝄛𝄛𝄛𝄛𝄛𝄛░░░𝄛𝄛𝄛𝄛𝄛𝄛𝄛𝄛𝄛𝄛𝄛𝄛𝄛𝄛𝄛𝄛𝄛𝄛𝄛𝄛𝄛𝄛𝄛𝄛𝄛𝄛𝄛𝄛𝄛░░░@░░░░░░░░░░░░░░░░░░░░░𝄛𝄛𝄛𝄛𝄛𝄛𝄛𝄛𝄛𝄛𝄛𝄛𝄛𝄛𝄛𝄛𝄛𝄛𝄛𝄛𝄛𝄛𝄛𝄛𝄛𝄛𝄛𝄛𝄛𝄛𝄛𝄛𝄛𝄛𝄛𝄛𝄛𝄛𝄛𝄛𝄛𝄛𝄛𝄛𝄛𝄛𝄛𝄛
𝄛𝄛𝄛𝄛𝄛𝄛𝄛𝄛𝄛𝄛𝄛𝄛𝄛𝄛𝄛𝄛𝄛𝄛𝄛𝄛𝄛𝄛𝄛𝄛𝄛𝄛𝄛𝄛𝄛𝄛𝄛𝄛𝄛𝄛𝄛░░░𝄛𝄛𝄛𝄛𝄛𝄛𝄛𝄛𝄛𝄛𝄛𝄛𝄛𝄛𝄛𝄛𝄛𝄛𝄛𝄛𝄛𝄛𝄛𝄛𝄛𝄛𝄛𝄛𝄛░░░░░░░░░░░░░░░░░░░░░░░░░𝄛𝄛𝄛𝄛𝄛𝄛𝄛𝄛𝄛𝄛𝄛𝄛𝄛𝄛𝄛𝄛𝄛𝄛𝄛𝄛𝄛𝄛𝄛𝄛𝄛𝄛𝄛𝄛𝄛𝄛𝄛𝄛𝄛𝄛𝄛𝄛𝄛𝄛𝄛𝄛𝄛𝄛𝄛𝄛𝄛𝄛𝄛𝄛
𝄛𝄛𝄛𝄛𝄛𝄛𝄛𝄛𝄛𝄛𝄛𝄛𝄛𝄛𝄛𝄛𝄛𝄛𝄛𝄛𝄛𝄛𝄛𝄛𝄛𝄛𝄛𝄛𝄛𝄛𝄛𝄛𝄛𝄛𝄛░░░𝄛𝄛𝄛𝄛𝄛𝄛𝄛𝄛𝄛𝄛𝄛𝄛𝄛𝄛𝄛𝄛𝄛𝄛𝄛𝄛𝄛𝄛𝄛𝄛𝄛𝄛𝄛𝄛𝄛░░░░░░░░░░░░░░░░░░░░░░░░░𝄛𝄛𝄛𝄛𝄛𝄛𝄛𝄛𝄛𝄛𝄛𝄛𝄛𝄛𝄛𝄛𝄛𝄛𝄛𝄛𝄛𝄛𝄛𝄛𝄛𝄛𝄛𝄛𝄛𝄛𝄛𝄛𝄛𝄛𝄛𝄛𝄛𝄛𝄛𝄛𝄛𝄛𝄛𝄛𝄛𝄛𝄛𝄛
𝄛𝄛𝄛𝄛𝄛𝄛𝄛𝄛𝄛𝄛𝄛𝄛𝄛𝄛𝄛𝄛𝄛𝄛𝄛𝄛𝄛𝄛𝄛𝄛𝄛𝄛𝄛𝄛𝄛𝄛𝄛𝄛𝄛𝄛𝄛░░░░░░𝄛𝄛𝄛𝄛𝄛𝄛𝄛𝄛𝄛𝄛𝄛𝄛𝄛𝄛𝄛𝄛𝄛𝄛𝄛𝄛𝄛𝄛𝄛𝄛𝄛𝄛░░░░░░░░░░░░░░░░░░░░░░░░░𝄛𝄛𝄛𝄛𝄛𝄛𝄛𝄛𝄛𝄛𝄛𝄛𝄛𝄛𝄛𝄛𝄛𝄛𝄛𝄛𝄛𝄛𝄛𝄛𝄛𝄛𝄛𝄛𝄛𝄛𝄛𝄛𝄛𝄛𝄛𝄛𝄛𝄛𝄛𝄛𝄛𝄛𝄛𝄛𝄛𝄛𝄛𝄛
𝄛𝄛𝄛𝄛𝄛𝄛𝄛𝄛𝄛𝄛𝄛𝄛𝄛𝄛𝄛𝄛𝄛𝄛𝄛𝄛𝄛𝄛𝄛𝄛𝄛𝄛𝄛𝄛𝄛𝄛𝄛𝄛░░░░░░░░░░░𝄛𝄛𝄛𝄛𝄛𝄛𝄛𝄛𝄛𝄛𝄛𝄛𝄛𝄛𝄛𝄛𝄛𝄛𝄛𝄛𝄛𝄛𝄛𝄛░░░░░░░░░░░░░░░░░░░░░░░░░░𝄛𝄛𝄛𝄛𝄛𝄛𝄛𝄛𝄛𝄛𝄛𝄛𝄛𝄛𝄛𝄛𝄛𝄛𝄛𝄛𝄛𝄛𝄛𝄛𝄛𝄛𝄛𝄛𝄛𝄛𝄛𝄛𝄛𝄛𝄛𝄛𝄛𝄛𝄛𝄛𝄛𝄛𝄛𝄛𝄛𝄛𝄛
𝄛𝄛𝄛𝄛𝄛𝄛𝄛𝄛𝄛𝄛𝄛𝄛𝄛𝄛𝄛𝄛𝄛𝄛𝄛𝄛𝄛𝄛𝄛𝄛𝄛𝄛𝄛𝄛𝄛𝄛░░░░░░░░░░░░░░𝄛𝄛𝄛𝄛𝄛𝄛𝄛𝄛𝄛𝄛𝄛𝄛𝄛𝄛𝄛𝄛𝄛𝄛𝄛𝄛𝄛𝄛𝄛𝄛░░░░░░░░░░░░░░░░░░░░░░░░░░░𝄛𝄛𝄛𝄛𝄛𝄛░░░░░𝄛𝄛𝄛𝄛𝄛𝄛𝄛𝄛𝄛𝄛𝄛𝄛𝄛𝄛𝄛𝄛𝄛𝄛𝄛𝄛𝄛𝄛𝄛𝄛𝄛𝄛𝄛𝄛𝄛𝄛𝄛𝄛𝄛𝄛
𝄛𝄛𝄛𝄛𝄛𝄛𝄛𝄛𝄛𝄛𝄛𝄛𝄛𝄛𝄛𝄛𝄛𝄛𝄛𝄛𝄛𝄛𝄛𝄛𝄛𝄛𝄛𝄛𝄛░░░░░░░░░░░░░░░░𝄛𝄛𝄛𝄛𝄛𝄛𝄛𝄛𝄛𝄛𝄛𝄛𝄛𝄛𝄛𝄛𝄛𝄛𝄛𝄛𝄛𝄛𝄛░░░░░░░░░░░░░░░░░░░░░░░░░░░░░𝄛𝄛░░░░░░░░░𝄛𝄛𝄛𝄛𝄛𝄛𝄛𝄛𝄛𝄛𝄛𝄛𝄛𝄛𝄛𝄛𝄛𝄛𝄛𝄛𝄛𝄛𝄛𝄛𝄛𝄛𝄛𝄛𝄛𝄛𝄛𝄛
𝄛𝄛𝄛𝄛𝄛𝄛𝄛𝄛𝄛𝄛𝄛𝄛𝄛𝄛𝄛𝄛𝄛𝄛𝄛𝄛𝄛𝄛𝄛𝄛𝄛░░░░░░░░░░░░░░░░░░░░𝄛𝄛𝄛𝄛𝄛𝄛𝄛𝄛𝄛𝄛𝄛𝄛𝄛𝄛𝄛𝄛𝄛𝄛𝄛𝄛𝄛𝄛𝄛𝄛░░░░░░░░░░░░░░░░░░░░░░░░░░░░░░░░░░░░░░░░𝄛𝄛𝄛𝄛𝄛𝄛𝄛𝄛𝄛░░░░░𝄛𝄛𝄛𝄛𝄛𝄛𝄛𝄛𝄛𝄛𝄛𝄛𝄛𝄛𝄛𝄛𝄛
𝄛𝄛𝄛𝄛𝄛𝄛𝄛𝄛𝄛𝄛𝄛𝄛𝄛𝄛𝄛𝄛𝄛𝄛𝄛𝄛𝄛𝄛𝄛𝄛░░░░░░░░░░░░░░░░░░░░░░𝄛𝄛𝄛𝄛𝄛𝄛𝄛𝄛𝄛𝄛𝄛𝄛𝄛𝄛𝄛𝄛𝄛𝄛𝄛𝄛𝄛𝄛𝄛░░░░░░░░░░░░░░░░░░░░░░░░░░░░░░░░░░░░░░░░░𝄛𝄛𝄛𝄛𝄛𝄛𝄛𝄛░░░░░𝄛𝄛𝄛𝄛𝄛𝄛𝄛𝄛𝄛𝄛𝄛𝄛𝄛𝄛𝄛𝄛𝄛
𝄛𝄛𝄛𝄛𝄛𝄛𝄛𝄛𝄛𝄛𝄛𝄛𝄛𝄛𝄛𝄛𝄛𝄛𝄛𝄛𝄛𝄛𝄛░░░░░░░░░░░░░░░░░░░░░░░░𝄛𝄛𝄛𝄛𝄛𝄛𝄛𝄛𝄛𝄛𝄛𝄛𝄛𝄛𝄛𝄛𝄛𝄛𝄛𝄛𝄛𝄛𝄛░░░░░░░░░░░░░░░░░░░░░░░░░░░░░░░░░░░░░░░░[37m𝄛(B[m░░░░░░░░░░░░𝄛𝄛𝄛𝄛𝄛𝄛𝄛𝄛𝄛𝄛𝄛𝄛𝄛𝄛𝄛𝄛𝄛
𝄛𝄛𝄛𝄛𝄛𝄛𝄛𝄛𝄛𝄛𝄛𝄛𝄛𝄛𝄛𝄛𝄛𝄛𝄛𝄛𝄛𝄛░░░░░░░░░░░░░░░𝄛𝄛░░░░░░░░░𝄛𝄛𝄛𝄛𝄛𝄛𝄛𝄛𝄛𝄛𝄛𝄛𝄛𝄛𝄛𝄛𝄛𝄛𝄛𝄛𝄛𝄛𝄛░░░░░░░░░░░░░░░░░░░░░░░░░░░░░░░░░░░░░░░𝄛𝄛𝄛𝄛𝄛𝄛𝄛𝄛░░░░░𝄛𝄛𝄛𝄛𝄛𝄛𝄛𝄛𝄛𝄛𝄛𝄛𝄛𝄛𝄛𝄛𝄛
𝄛𝄛𝄛𝄛𝄛𝄛𝄛𝄛𝄛𝄛𝄛𝄛𝄛𝄛𝄛𝄛𝄛𝄛𝄛𝄛𝄛𝄛░░░░░░░░░░░░𝄛𝄛𝄛𝄛𝄛𝄛𝄛𝄛𝄛𝄛░░░░░𝄛𝄛𝄛𝄛𝄛𝄛𝄛𝄛𝄛𝄛𝄛𝄛𝄛𝄛𝄛𝄛𝄛𝄛░░░░░░░░░░░░░░░░░░░░░░░░░░░░░░░░░░░░░░░░░░░𝄛𝄛𝄛𝄛𝄛𝄛𝄛𝄛░░░░░𝄛𝄛𝄛𝄛𝄛𝄛𝄛𝄛𝄛𝄛𝄛𝄛𝄛𝄛𝄛𝄛𝄛
𝄛𝄛𝄛𝄛𝄛𝄛𝄛𝄛𝄛𝄛𝄛𝄛𝄛𝄛𝄛𝄛𝄛𝄛𝄛𝄛𝄛𝄛░░░░░░░░░░░𝄛𝄛𝄛𝄛𝄛𝄛𝄛𝄛𝄛𝄛𝄛𝄛░░░░𝄛𝄛𝄛𝄛𝄛𝄛𝄛𝄛𝄛𝄛𝄛𝄛𝄛𝄛𝄛░░░░░░░░░░░░░░░░░░░░░░░░░░░░░░░░░░░░░░░░░░░░░░𝄛𝄛𝄛𝄛𝄛𝄛𝄛𝄛𝄛𝄛𝄛𝄛𝄛𝄛𝄛𝄛𝄛𝄛𝄛𝄛𝄛𝄛𝄛𝄛𝄛𝄛𝄛𝄛𝄛𝄛
𝄛𝄛𝄛𝄛𝄛𝄛𝄛𝄛𝄛𝄛𝄛𝄛𝄛𝄛𝄛𝄛𝄛𝄛𝄛𝄛𝄛░░░░░░░░░░░░𝄛𝄛𝄛𝄛𝄛𝄛𝄛𝄛𝄛𝄛𝄛𝄛𝄛░░░𝄛𝄛𝄛𝄛𝄛𝄛𝄛𝄛𝄛𝄛𝄛𝄛𝄛𝄛░░░░░░░░░░░░░░░░░░░░░░░░░░░░░░░░░░░░░░░░░░░░░░░𝄛𝄛𝄛𝄛𝄛𝄛𝄛𝄛𝄛𝄛𝄛𝄛𝄛𝄛𝄛𝄛𝄛𝄛𝄛𝄛𝄛𝄛𝄛𝄛𝄛𝄛𝄛𝄛𝄛𝄛
𝄛𝄛𝄛𝄛𝄛𝄛𝄛𝄛𝄛𝄛𝄛𝄛𝄛𝄛𝄛𝄛𝄛𝄛𝄛𝄛𝄛░░░░░░░░░░░░𝄛𝄛𝄛𝄛𝄛𝄛𝄛𝄛𝄛𝄛𝄛𝄛𝄛░░░░𝄛𝄛𝄛𝄛𝄛𝄛𝄛𝄛𝄛𝄛𝄛𝄛░░░░░░░░░░░░░░░░░░░░░░░░░░░░░░░░░░░░░░░░░░░░░░░░𝄛𝄛𝄛𝄛𝄛𝄛𝄛𝄛𝄛𝄛𝄛𝄛𝄛𝄛𝄛𝄛𝄛𝄛𝄛𝄛𝄛𝄛𝄛𝄛𝄛𝄛𝄛𝄛𝄛𝄛
𝄛𝄛𝄛𝄛𝄛𝄛𝄛𝄛𝄛𝄛𝄛𝄛𝄛𝄛𝄛𝄛𝄛𝄛𝄛𝄛░░░░░░░░░░░░░𝄛𝄛𝄛𝄛𝄛𝄛𝄛𝄛𝄛𝄛𝄛𝄛𝄛░░░░𝄛𝄛𝄛𝄛𝄛𝄛𝄛𝄛𝄛𝄛𝄛░░░░░░░░░░░░░░░░░░░░░░░░░░░░░░░░░░░░░░░░░░░░░░░░░𝄛𝄛𝄛𝄛𝄛𝄛𝄛𝄛𝄛𝄛𝄛𝄛𝄛𝄛𝄛𝄛𝄛𝄛𝄛𝄛𝄛𝄛𝄛𝄛𝄛𝄛𝄛𝄛𝄛𝄛
𝄛𝄛𝄛𝄛𝄛𝄛𝄛𝄛𝄛𝄛𝄛𝄛𝄛𝄛𝄛𝄛𝄛𝄛𝄛𝄛░░░░░░░░░░░░░𝄛𝄛𝄛𝄛𝄛𝄛𝄛𝄛𝄛𝄛𝄛𝄛𝄛𝄛░░░𝄛𝄛𝄛𝄛𝄛𝄛𝄛𝄛𝄛░░░░░░░░░░░░░░░░░░░░░░░░░░░░░░░░░░░░░░░░░░░░░░░░░░░𝄛𝄛𝄛𝄛𝄛𝄛𝄛𝄛𝄛𝄛𝄛𝄛𝄛𝄛𝄛𝄛𝄛𝄛𝄛𝄛𝄛𝄛𝄛𝄛𝄛𝄛𝄛𝄛𝄛𝄛
𝄛𝄛𝄛𝄛𝄛𝄛𝄛𝄛𝄛𝄛𝄛𝄛𝄛𝄛𝄛𝄛𝄛𝄛𝄛░░░░░░░░░░░░░𝄛𝄛𝄛𝄛𝄛𝄛𝄛𝄛𝄛𝄛𝄛𝄛𝄛𝄛𝄛░░░𝄛𝄛𝄛𝄛𝄛𝄛𝄛𝄛░░░░░░░░░░░░░░░░░░░░░░░░░░░░░░░░░░░░░░░░░░░░░░░░░░░𝄛𝄛𝄛𝄛𝄛𝄛𝄛𝄛𝄛𝄛𝄛𝄛𝄛𝄛𝄛𝄛𝄛𝄛𝄛𝄛𝄛𝄛𝄛𝄛𝄛𝄛𝄛𝄛𝄛𝄛𝄛
𝄛𝄛𝄛𝄛𝄛𝄛𝄛𝄛𝄛𝄛𝄛𝄛𝄛𝄛𝄛𝄛░░░░░░░░░░░░░░░░𝄛𝄛𝄛𝄛𝄛𝄛𝄛𝄛𝄛𝄛𝄛𝄛𝄛𝄛𝄛░░░𝄛𝄛𝄛𝄛𝄛𝄛𝄛░░░░░░░░░░░░░░░░░░░░░░░░░░░░░░░░░░░░░░░░░░░░░░░░░░░𝄛𝄛𝄛𝄛𝄛𝄛𝄛𝄛𝄛𝄛𝄛𝄛𝄛𝄛𝄛𝄛𝄛𝄛𝄛𝄛𝄛𝄛𝄛𝄛𝄛𝄛𝄛𝄛𝄛𝄛𝄛𝄛
𝄛𝄛𝄛𝄛𝄛𝄛𝄛𝄛𝄛𝄛𝄛𝄛𝄛𝄛░░░░░░░░░░░░░░░░░𝄛𝄛𝄛𝄛𝄛𝄛𝄛𝄛𝄛𝄛𝄛𝄛𝄛𝄛𝄛𝄛░░░░░░░░░░░░░░░░░░░░░░░░░░░░░░░░░░░░░░░░░░░░░░░░░░░░░░░░░░░░𝄛𝄛𝄛𝄛𝄛𝄛𝄛𝄛𝄛𝄛𝄛𝄛𝄛𝄛𝄛𝄛𝄛𝄛𝄛𝄛𝄛𝄛𝄛𝄛𝄛𝄛𝄛𝄛𝄛𝄛𝄛𝄛𝄛
𝄛𝄛𝄛𝄛𝄛𝄛𝄛𝄛𝄛𝄛𝄛𝄛░░░░░░░░░░░░░░░░░░░𝄛𝄛𝄛𝄛𝄛𝄛𝄛𝄛𝄛𝄛𝄛𝄛𝄛𝄛𝄛░░░░░░░░░░░░░░░░░░░░░░░░░░░░░░░░░░░░░░░░░░░░░░░░░░░░░░░░░░░░░𝄛𝄛𝄛𝄛𝄛𝄛𝄛𝄛𝄛𝄛𝄛𝄛𝄛𝄛𝄛𝄛𝄛𝄛𝄛𝄛𝄛𝄛𝄛𝄛𝄛𝄛𝄛𝄛𝄛𝄛𝄛𝄛𝄛
𝄛𝄛𝄛𝄛𝄛𝄛𝄛𝄛𝄛𝄛𝄛░░░░░░░░░░░░░░░░░░░𝄛𝄛𝄛𝄛𝄛𝄛𝄛𝄛𝄛𝄛𝄛𝄛𝄛𝄛𝄛░░░░░░░░░░░░░░░░░░░░░░░░░░░░░░░░░░░░░░░░░░░░░░░░░░░░░░░░░░░░░░𝄛𝄛𝄛𝄛𝄛𝄛𝄛𝄛𝄛𝄛𝄛𝄛𝄛𝄛𝄛𝄛𝄛𝄛𝄛𝄛𝄛𝄛𝄛𝄛𝄛𝄛𝄛𝄛𝄛𝄛𝄛𝄛𝄛
